Script started on 2020-04-06 18:13:12-0700
blighte@cf164-19:~$ cd ~
blighte@cf164-19:~$ mkdir csci241
blighte@cf164-19:~$ cd csci241
blighte@cf164-19:~/csci241$ ls
blighte@cf164-19:~/csci241$ git clone https://github.com/csci241-20s/lab-1-Ethan-Blight
Cloning into 'lab-1-Ethan-Blight'...
remote: Enumerating objects: 14, done.[K
remote: Counting objects:   7% (1/14)[Kremote: Counting objects:  14% (2/14)[Kremote: Counting objects:  21% (3/14)[Kremote: Counting objects:  28% (4/14)[Kremote: Counting objects:  35% (5/14)[Kremote: Counting objects:  42% (6/14)[Kremote: Counting objects:  50% (7/14)[Kremote: Counting objects:  57% (8/14)[Kremote: Counting objects:  64% (9/14)[Kremote: Counting objects:  71% (10/14)[Kremote: Counting objects:  78% (11/14)[Kremote: Counting objects:  85% (12/14)[Kremote: Counting objects:  92% (13/14)[Kremote: Counting objects: 100% (14/14)[Kremote: Counting objects: 100% (14/14), done.[K
remote: Compressing objects:  12% (1/8)[Kremote: Compressing objects:  25% (2/8)[Kremote: Compressing objects:  37% (3/8)[Kremote: Compressing objects:  50% (4/8)[Kremote: Compressing objects:  62% (5/8)[Kremote: Compressing objects:  75% (6/8)[Kremote: Compressing objects:  87% (7/8)[Kremote: Compressing objects: 100% (8/8)[Kremote: Compressing objects: 100% (8/8), done.[K
remote: Total 14 (delta 2), reused 0 (delta 0), pack-reused 0[K
Unpacking objects:   7% (1/14)   Unpacking objects:  14% (2/14)   Unpacking objects:  21% (3/14)   Unpacking objects:  28% (4/14)   Unpacking objects:  35% (5/14)   Unpacking objects:  42% (6/14)   Unpacking objects:  50% (7/14)   Unpacking objects:  57% (8/14)   Unpacking objects:  64% (9/14)   Unpacking objects:  71% (10/14)   Unpacking objects:  78% (11/14)   Unpacking objects:  85% (12/14)   Unpacking objects:  92% (13/14)   Unpacking objects: 100% (14/14)   Unpacking objects: 100% (14/14), done.
blighte@cf164-19:~/csci241$ git config --global user.name "Ethan Blioght"[K[K[K[K[Kght[K[Kht"
blighte@cf164-19:~/csci241$ gt[Kit cvon[K[K[K[Kconfig --global user.email "blighte@wwu.edu"
blighte@cf164-19:~/csci241$ touch writeup.txc[Kt
blighte@cf164-19:~/csci241$ git add writeup.txt # run "git help add" for details[K[K[K[K[K[K[K[K[K[K[K[K[K[K[K[K[K[K[K[K[K[K[K[K[K[K[K[K[K[K[K[K[K
fatal: not a git repository (or any parent up to mount point /)
Stopping at filesystem boundary (GIT_DISCOVERY_ACROSS_FILESYSTEM not set).
blighte@cf164-19:~/csci241$ git help add
[?1049h[22;0;0t[?1h=GIT-ADD(1)                                                                                                                                            Git Manual                                                                                                                                           GIT-ADD(1)[m
[m
[1mNAME[0m[m
       git-add - Add file contents to the index[m
[m
[1mSYNOPSIS[0m[m
       [4mgit[24m [4madd[24m [--verbose | -v] [--dry-run | -n] [--force | -f] [--interactive | -i] [--patch | -p][m
                 [--edit | -e] [--[no-]all | --[no-]ignore-removal | [--update | -u]][m
                 [--intent-to-add | -N] [--refresh] [--ignore-errors] [--ignore-missing] [--renormalize][m
                 [--chmod=(+|-)x] [--] [<pathspec>...][m
[m
[1mDESCRIPTION[0m[m
       This command updates the index using the current content found in the working tree, to prepare the content staged for the next commit. It typically adds the current content of existing paths as a whole, but with some options it can also be used to add content with only part of the changes made to the[m
       working tree files applied, or remove paths that do not exist in the working tree anymore.[m
[m
       The "index" holds a snapshot of the content of the working tree, and it is this snapshot that is taken as the contents of the next commit. Thus after making any changes to the working tree, and before running the commit command, you must use the [1madd[0m command to add any new or modified files to the[m
       index.[m
[m
       This command can be performed multiple times before a commit. It only adds the content of the specified file(s) at the time the add command is run; if you want subsequent changes included in the next commit, then you must run [1mgit[0m [1madd[0m again to add the new content to the index.[m
[m
       The [1mgit[0m [1mstatus[0m command can be used to obtain a summary of which files have changes that are staged for the next commit.[m
[m
       The [1mgit[0m [1madd[0m command will not add ignored files by default. If any ignored files were explicitly specified on the command line, [1mgit[0m [1madd[0m will fail with a list of ignored files. Ignored files reached by directory recursion or filename globbing performed by Git (quote your globs before the shell) will be[m
       silently ignored. The [4mgit[24m [4madd[24m command can be used to add ignored files with the [1m-f[0m (force) option.[m
[m
       Please see [1mgit-commit[0m(1) for alternative ways to add content to a commit.[m
[m
[1mOPTIONS[0m[m
       <pathspec>...[m
           Files to add content from. Fileglobs (e.g.  [1m*.c[0m) can be given to add all matching files. Also a leading directory name (e.g.  [1mdir[0m to add [1mdir/file1[0m and [1mdir/file2[0m) can be given to update the index to match the current state of the directory as a whole (e.g. specifying [1mdir[0m will record not just a file[m
           [1mdir/file1[0m modified in the working tree, a file [1mdir/file2[0m added to the working tree, but also a file [1mdir/file3[0m removed from the working tree. Note that older versions of Git used to ignore removed files; use [1m--no-all[0m option if you want to add modified or new files but ignore removed ones.[m
[m
           For more details about the <pathspec> syntax, see the [4mpathspec[24m entry in [1mgitglossary[0m(7).[m
[m
       -n, --dry-run[m
           Don’t actually add the file(s), just show if they exist and/or will be ignored.[m
[m
       -v, --verbose[m
           Be verbose.[m
[m
       -f, --force[m
           Allow adding otherwise ignored files.[m
[m
       -i, --interactive[m
           Add modified contents in the working tree interactively to the index. Optional path arguments may be supplied to limit operation to a subset of the working tree. See “Interactive mode” for details.[m
[m
       -p, --patch[m
           Interactively choose hunks of patch between the index and the work tree and add them to the index. This gives the user a chance to review the difference before adding modified contents to the index.[m
[m
           This effectively runs [1madd[0m [1m--interactive[0m, but bypasses the initial command menu and directly jumps to the [1mpatch[0m subcommand. See “Interactive mode” for details.[m
[m
       -e, --edit[m
           Open the diff vs. the index in an editor and let the user edit it. After the editor was closed, adjust the hunk headers and apply the patch to the index.[m
[m
           The intent of this option is to pick and choose lines of the patch to apply, or even to modify the contents of lines to be staged. This can be quicker and more flexible than using the interactive hunk selector. However, it is easy to confuse oneself and create a patch that does not apply to the[m
           index. See EDITING PATCHES below.[m
[m
       -u, --update[m
           Update the index just where it already has an entry matching <pathspec>. This removes as well as modifies index entries to match the working tree, but adds no new files.[m
[m
           If no <pathspec> is given when [1m-u[0m option is used, all tracked files in the entire working tree are updated (old versions of Git used to limit the update to the current directory and its subdirectories).[m
[m
       -A, --all, --no-ignore-removal[m
           Update the index not only where the working tree has a file matching <pathspec> but also where the index already has an entry. This adds, modifies, and removes index entries to match the working tree.[m
[m
           If no <pathspec> is given when [1m-A[0m option is used, all files in the entire working tree are updated (old versions of Git used to limit the update to the current directory and its subdirectories).[m
[m
       --no-all, --ignore-removal[m
           Update the index by adding new files that are unknown to the index and files modified in the working tree, but ignore files that have been removed from the working tree. This option is a no-op when no <pathspec> is used.[m
[m
           This option is primarily to help users who are used to older versions of Git, whose "git add <pathspec>..." was a synonym for "git add --no-all <pathspec>...", i.e. ignored removed files.[m
[m
       -N, --intent-to-add[m
           Record only the fact that the path will be added later. An entry for the path is placed in the index with no content. This is useful for, among other things, showing the unstaged content of such files with [1mgit[0m [1mdiff[0m and committing them with [1mgit[0m [1mcommit[0m [1m-a[0m.[m
[m
       --refresh[m
           Don’t add the file(s), but only refresh their stat() information in the index.[m
[m
       --ignore-errors[m
           If some files could not be added because of errors indexing them, do not abort the operation, but continue adding the others. The command shall still exit with non-zero status. The configuration variable [1madd.ignoreErrors[0m can be set to true to make this the default behaviour.[m
[m
       --ignore-missing[m
           This option can only be used together with --dry-run. By using this option the user can check if any of the given files would be ignored, no matter if they are already present in the work tree or not.[m
[m
       --no-warn-embedded-repo[m
[7m Manual page git-add(1) line 1 (press h for help or q to quit)[27m[K[K[?1l>[?1049l[23;0;0tblighte@cf164-19:~/csci241$ git help addadd writeup.txt
fatal: not a git repository (or any parent up to mount point /)
Stopping at filesystem boundary (GIT_DISCOVERY_ACROSS_FILESYSTEM not set).
blighte@cf164-19:~/csci241$ cd lab-1-Ethan-Blight
blighte@cf164-19:~/csci241/lab-1-Ethan-Blight$ cd ..
blighte@cf164-19:~/csci241$ remot[K=[K[K[K[K[Krm we[K[Kwriteup.ytx[K[K[Ktxt
blighte@cf164-19:~/csci241$ rm writeup.txt[9Pcd ..lab-1-Ethan-Blight
blighte@cf164-19:~/csci241/lab-1-Ethan-Blight$ touch writeup.txt
blighte@cf164-19:~/csci241/lab-1-Ethan-Blight$ touch writeup.txtcd lab-1-Ethan-Blight[7Prm writeup.txtcd lab-1-Ethan-Blight[7Prm writeup.txt[9Pcd ..lab-1-Ethan-Blight[2Pgit add writeup.txt
blighte@cf164-19:~/csci241/lab-1-Ethan-Blight$ git commit -m "Added empty writeup"
[master 99ea2e0] Added empty writeup
 1 file changed, 0 insertions(+), 0 deletions(-)
 create mode 100644 writeup.txt
blighte@cf164-19:~/csci241/lab-1-Ethan-Blight$ git oush[K[K[K[Ko[Kpush orogin[K[K[K[Kigin master
Username for 'https://github.com': blighte@wwu.eduy 
Password for 'https://blighte@wwu.edu@github.com': 
Counting objects: 2, done.
Delta compression using up to 8 threads.
Compressing objects:  50% (1/2)   Compressing objects: 100% (2/2)   Compressing objects: 100% (2/2), done.
Writing objects:  50% (1/2)   Writing objects: 100% (2/2)   Writing objects: 100% (2/2), 270 bytes | 270.00 KiB/s, done.
Total 2 (delta 1), reused 0 (delta 0)
remote: Resolving deltas:   0% (0/1)[Kremote: Resolving deltas: 100% (1/1)[Kremote: Resolving deltas: 100% (1/1), completed with 1 local object.[K
To https://github.com/csci241-20s/lab-1-Ethan-Blight
   8b9e8ff..99ea2e0  master -> master
blighte@cf164-19:~/csci241/lab-1-Ethan-Blight$ nano writeup.txt
[?1049h[22;0;0t[1;86r(B[m[4l[?7h[39;49m[?1h=[?1h=[?1h=[?25l[39;49m(B[m[H[2J[84;151H(B[0;7m[ Reading File ](B[m[84;157H(B[0;7m 0 lines ](B[m[H(B[0;7m  GNU nano 2.9.3                                                                                                                                            writeup.txt                                                                                                                                                      [1;316H(B[m[85d(B[0;7m^G(B[m Get Help[19G(B[0;7m^O(B[m Write Out[37G(B[0;7m^W(B[m Where Is[55G(B[0;7m^K(B[m Cut Text[73G(B[0;7m^J(B[m Justify[85;91H(B[0;7m^C(B[m Cur Pos[85;109H(B[0;7mM-U(B[m Undo[85;127H(B[0;7mM-A(B[m Mark Text     (B[0;7mM-](B[m To Bracket    (B[0;7mM-▲(B[m Previous[181G(B[0;7m^B(B[m Back[85;199H(B[0;7m^◀(B[m Prev Word[217G(B[0;7m^A(B[m Home[85;235H(B[0;7m^P(B[m Prev Line[253G(B[0;7mM--(B[m Scroll Up     (B[0;7m^▲(B[m Prev Block     (B[0;7mM-((B[m Beg of Par[86d(B[0;7m^X(B[m Exit[86;19H(B[0;7m^R(B[m Read File[37G(B[0;7m^\(B[m Replace[86;55H(B[0;7m^U(B[m Uncut Text     (B[0;7m^T(B[m To Spell[91G(B[0;7m^_(B[m Go To Line     (B[0;7mM-E(B[m Redo[86;127H(B[0;7mM-6(B[m Copy Text     (B[0;7mM-W(B[m WhereIs Next  (B[0;7mM-▼(B[m Next[86;181H(B[0;7m^F(B[m Forward[86;199H(B[0;7m^▶(B[m Next Word[217G(B[0;7m^E(B[m End[86;235H(B[0;7m^N(B[m Next Line[253G(B[0;7mM-+(B[m Scroll Down   (B[0;7m^▼(B[m Next Block     (B[0;7mM-)(B[m End of Par[84d[3d[39;49m(B[m[?12l[?25h[?25l[1;308H(B[0;7mModified(B[m[3d1[?12l[?25h[?25l)[?12l[?25h[?25l [?12l[?25h[?25lE[?12l[?25h[?25lt[?12l[?25h[?25lh[?12l[?25h[?25la[?12l[?25h[?25ln[?12l[?25h[?25l [?12l[?25h[?25lB[?12l[?25h[?25ll[?12l[?25h[?25li[?12l[?25h[?25lg[?12l[?25h[?25lh[?12l[?25h[?25lt[?12l[?25h[?25l[84d(B[0;7mSave modified buffer?  (Answering "No" will DISCARD changes.)                                                                                                                                                                                                                                                                [85;1H Y(B[m Yes[K[86d(B[0;7m N(B[m No  [86;17H(B[0;7m^C(B[m Cancel[K[84;63H[?12l[?25h[?25l[85d(B[0;7m^G(B[m Get Help[85;80H(B[0;7mM-D(B[m DOS Format[85;159H(B[0;7mM-A(B[m Append[85;238H(B[0;7mM-B(B[m Backup File[86d(B[0;7m^C(B[m Cancel[17G         [86;80H(B[0;7mM-M(B[m Mac Format[86;159H(B[0;7mM-P(B[m Prepend[86;238H(B[0;7m^T(B[m To Files[84d(B[0;7mFile Name to Write: writeup.txt                              (B[m[84;32H[?12l[?25h[?25l[K[1;316H[1;308H(B[0;7m        (B[m[84;151H(B[0;7m[ Wrote 1 line ](B[m[J[86;317H[?12l[?25h[86;1H[?1049l[23;0;0t[?1l>blighte@cf164-19:~/csci241/lab-1-Ethan-Blight$ git add writeup.tct[K[Kxt
blighte@cf164-19:~/csci241/lab-1-Ethan-Blight$ git commit -m "Added paert[K[K[Krt 1 (names) to weri[K[K[Kriteup"
[master 376ee1f] Added part 1 (names) to writeup
 1 file changed, 1 insertion(+)
blighte@cf164-19:~/csci241/lab-1-Ethan-Blight$ git status
On branch master
Your branch is ahead of 'origin/master' by 1 commit.
  (use "git push" to publish your local commits)

nothing to commit, working tree clean
blighte@cf164-19:~/csci241/lab-1-Ethan-Blight$ nano writeup.txt
[?1049h[22;0;0t[1;86r(B[m[4l[?7h[39;49m[?1h=[?1h=[?1h=[?25l[39;49m(B[m[H[2J[84;151H(B[0;7m[ Reading File ](B[m[84;151H (B[0;7m[ Read 1 line ](B[m[H(B[0;7m  GNU nano 2.9.3                                                                                                                                            writeup.txt                                                                                                                                                      [1;316H(B[m[85d(B[0;7m^G(B[m Get Help[19G(B[0;7m^O(B[m Write Out[37G(B[0;7m^W(B[m Where Is[55G(B[0;7m^K(B[m Cut Text[73G(B[0;7m^J(B[m Justify[85;91H(B[0;7m^C(B[m Cur Pos[85;109H(B[0;7mM-U(B[m Undo[85;127H(B[0;7mM-A(B[m Mark Text     (B[0;7mM-](B[m To Bracket    (B[0;7mM-▲(B[m Previous[181G(B[0;7m^B(B[m Back[85;199H(B[0;7m^◀(B[m Prev Word[217G(B[0;7m^A(B[m Home[85;235H(B[0;7m^P(B[m Prev Line[253G(B[0;7mM--(B[m Scroll Up     (B[0;7m^▲(B[m Prev Block     (B[0;7mM-((B[m Beg of Par[86d(B[0;7m^X(B[m Exit[86;19H(B[0;7m^R(B[m Read File[37G(B[0;7m^\(B[m Replace[86;55H(B[0;7m^U(B[m Uncut Text     (B[0;7m^T(B[m To Spell[91G(B[0;7m^_(B[m Go To Line     (B[0;7mM-E(B[m Redo[86;127H(B[0;7mM-6(B[m Copy Text     (B[0;7mM-W(B[m WhereIs Next  (B[0;7mM-▼(B[m Next[86;181H(B[0;7m^F(B[m Forward[86;199H(B[0;7m^▶(B[m Next Word[217G(B[0;7m^E(B[m End[86;235H(B[0;7m^N(B[m Next Line[253G(B[0;7mM-+(B[m Scroll Down   (B[0;7m^▼(B[m Next Block     (B[0;7mM-)(B[m End of Par[84d[3d[39;49m(B[m1) Ethan Blight[?12l[?25h[?25l1[?12l[?25h[?25l)[?12l[?25h[?25l [?12l[?25h[?25lE[?12l[?25h[?25lt[?12l[?25h[?25lh[?12l[?25h[?25la[?12l[?25h[?25ln[?12l[?25h[?25l [?12l[?25h[?25lB[?12l[?25h[?25ll[?12l[?25h[?25li[?12l[?25h[?25lg[?12l[?25h[?25lh[?12l[?25h[?25lt[?12l[?25h[?25l[4d[?12l[?25h[?25l[?12l[?25h[?25l[3;16H[?12l[?25h[?25l[1;308H(B[0;7mModified(B[m[4d[?12l[?25h[?25l[5d[?12l[?25h[?25l[?12l[?25h[?25l[A[?12l[?25h[?25l[5d[?12l[?25h[?25l[A[?12l[?25h[?25l[3;16H[?12l[?25h[?25l[84d[K[4d[?12l[?25h[?25l[3;16H[?12l[?25h[?25l[4d[?12l[?25h[?25l2[?12l[?25h[?25l)[?12l[?25h[?25l [?12l[?25h[?25l[?12l[?25h[?25l [?12l[?25h[?25l[K[?12l[?25h[?25l[5d[?12l[?25h[?25l2[?12l[?25h[?25l)[?12l[?25h[?25l [?12l[?25h[?25lH[?12l[?25h[?25lo[?12l[?25h[?25lb[?12l[?25h[?25lb[?12l[?25h[?25ly[?12l[?25h[?25l:[?12l[?25h[?25l [?12l[?25h[?25lP[?12l[?25h[?25lr[?12l[?25h[?25lo[?12l[?25h[?25lg[?12l[?25h[?25lr[?12l[?25h[?25la[?12l[?25h[?25lm[?12l[?25h[?25lm[?12l[?25h[?25li[?12l[?25h[?25ln[?12l[?25h[?25lg[?12l[?25h[?25l[84d(B[0;7mSave modified buffer?  (Answering "No" will DISCARD changes.)                                                                                                                                                                                                                                                                [85;1H Y(B[m Yes[K[86d(B[0;7m N(B[m No  [86;17H(B[0;7m^C(B[m Cancel[K[84;63H[?12l[?25h[?25l[85d(B[0;7m^G(B[m Get Help[85;80H(B[0;7mM-D(B[m DOS Format[85;159H(B[0;7mM-A(B[m Append[85;238H(B[0;7mM-B(B[m Backup File[86d(B[0;7m^C(B[m Cancel[17G         [86;80H(B[0;7mM-M(B[m Mac Format[86;159H(B[0;7mM-P(B[m Prepend[86;238H(B[0;7m^T(B[m To Files[84d(B[0;7mFile Name to Write: writeup.txt                              (B[m[84;32H[?12l[?25h[?25l[K[1;316H[1;308H(B[0;7m        (B[m[84;151H(B[0;7m[ Wrote 3 lines ](B[m[J[86;317H[?12l[?25h[86;1H[?1049l[23;0;0t[?1l>blighte@cf164-19:~/csci241/lab-1-Ethan-Blight$ nano writeup.txt[6Pgit status
On branch master
Your branch is ahead of 'origin/master' by 1 commit.
  (use "git push" to publish your local commits)

Changes not staged for commit:
  (use "git add <file>..." to update what will be committed)
  (use "git checkout -- <file>..." to discard changes in working directory)

	[31mmodified:   writeup.txt[m

no changes added to commit (use "git add" and/or "git commit -a")
blighte@cf164-19:~/csci241/lab-1-Ethan-Blight$ git statusnano writeup.txt[6Pgit statuscommit -m "Added part 1 (names) to writeup"[K[K[K[K[K[K[K[K[K[K[K[K[K[K[K[K[K[K[K[K[K2 (hobbie[K[Ky) to weri[K[K[Kriteup"[K[K[K[K[K[K[K[K[K[K[K[K[K[K[K[K[K[K[K[K[K[K[K[K[K[K[K[K[K[K[K[K[K[K[K[K[K[K[K[K[K[K[K[K[K[K[Knano writeup.tc[Kxt
[?1049h[22;0;0t[1;86r(B[m[4l[?7h[39;49m[?1h=[?1h=[?1h=[?25l[39;49m(B[m[H[2J[84;151H(B[0;7m[ Reading File ](B[m[84;157H(B[0;7m 3 lines ](B[m[H(B[0;7m  GNU nano 2.9.3                                                                                                                                            writeup.txt                                                                                                                                                      [1;316H(B[m[85d(B[0;7m^G(B[m Get Help[19G(B[0;7m^O(B[m Write Out[37G(B[0;7m^W(B[m Where Is[55G(B[0;7m^K(B[m Cut Text[73G(B[0;7m^J(B[m Justify[85;91H(B[0;7m^C(B[m Cur Pos[85;109H(B[0;7mM-U(B[m Undo[85;127H(B[0;7mM-A(B[m Mark Text     (B[0;7mM-](B[m To Bracket    (B[0;7mM-▲(B[m Previous[181G(B[0;7m^B(B[m Back[85;199H(B[0;7m^◀(B[m Prev Word[217G(B[0;7m^A(B[m Home[85;235H(B[0;7m^P(B[m Prev Line[253G(B[0;7mM--(B[m Scroll Up     (B[0;7m^▲(B[m Prev Block     (B[0;7mM-((B[m Beg of Par[86d(B[0;7m^X(B[m Exit[86;19H(B[0;7m^R(B[m Read File[37G(B[0;7m^\(B[m Replace[86;55H(B[0;7m^U(B[m Uncut Text     (B[0;7m^T(B[m To Spell[91G(B[0;7m^_(B[m Go To Line     (B[0;7mM-E(B[m Redo[86;127H(B[0;7mM-6(B[m Copy Text     (B[0;7mM-W(B[m WhereIs Next  (B[0;7mM-▼(B[m Next[86;181H(B[0;7m^F(B[m Forward[86;199H(B[0;7m^▶(B[m Next Word[217G(B[0;7m^E(B[m End[86;235H(B[0;7m^N(B[m Next Line[253G(B[0;7mM-+(B[m Scroll Down   (B[0;7m^▼(B[m Next Block     (B[0;7mM-)(B[m End of Par[84d[3d[39;49m(B[m1) Ethan Blight[5d2) Hobby: Programming[3d[?12l[?25h[?25l[?12l[?25h[?25l[4d[?12l[?25h[?25l[5d[?12l[?25h[?25l2[?12l[?25h[?25l)[?12l[?25h[?25l[5;22H[?12l[?25h[?25l[1;308H(B[0;7mModified(B[m[5;21H [?12l[?25h[?25l [?12l[?25h[?25l [?12l[?25h[?25l [?12l[?25h[?25l [?12l[?25h[?25l [?12l[?25h[?25l [?12l[?25h[?25l [?12l[?25h[?25l [?12l[?25h[?25l [?12l[?25h[?25l [?12l[?25h[?25l[?12l[?25h[?25l [?12l[?25h[?25l [?12l[?25h[?25l [?12l[?25h[?25l [?12l[?25h[?25l [?12l[?25h[?25l [?12l[?25h[?25l[?12l[?25h[?25l [84d[K[5d2[?12l[?25h[?25l[K[?12l[?25h[?25l[A[?12l[?25h[?25l[3;16H[?12l[?25h[?25l[84d(B[0;7mSave modified buffer?  (Answering "No" will DISCARD changes.)                                                                                                                                                                                                                                                                [85;1H Y(B[m Yes[K[86d(B[0;7m N(B[m No  [86;17H(B[0;7m^C(B[m Cancel[K[84;63H[?12l[?25h[?25l[85d(B[0;7m^G(B[m Get Help[85;80H(B[0;7mM-D(B[m DOS Format[85;159H(B[0;7mM-A(B[m Append[85;238H(B[0;7mM-B(B[m Backup File[86d(B[0;7m^C(B[m Cancel[17G         [86;80H(B[0;7mM-M(B[m Mac Format[86;159H(B[0;7mM-P(B[m Prepend[86;238H(B[0;7m^T(B[m To Files[84d(B[0;7mFile Name to Write: writeup.txt                              (B[m[84;32H[?12l[?25h[?25l[K[1;316H[1;308H(B[0;7m        (B[m[84;151H(B[0;7m[ Wrote 1 line ](B[m[J[86;317H[?12l[?25h[86;1H[?1049l[23;0;0t[?1l>blighte@cf164-19:~/csci241/lab-1-Ethan-Blight$ nano writeup.txt[6Pgit statusnano writeup.txt[6Pgit statuscommit -m "Added part 1 (names) to writeup"
On branch master
Your branch is ahead of 'origin/master' by 1 commit.
  (use "git push" to publish your local commits)

nothing to commit, working tree clean
blighte@cf164-19:~/csci241/lab-1-Ethan-Blight$ git push origin master[K[K[K[K[K[K[K[K[K[K[K[K[K[K[K[K[K[K[K[K[K[Knano writeup.txt
[?1049h[22;0;0t[1;86r(B[m[4l[?7h[39;49m[?1h=[?1h=[?1h=[?25l[39;49m(B[m[H[2J[84;151H(B[0;7m[ Reading File ](B[m[84;151H (B[0;7m[ Read 1 line ](B[m[H(B[0;7m  GNU nano 2.9.3                                                                                                                                            writeup.txt                                                                                                                                                      [1;316H(B[m[85d(B[0;7m^G(B[m Get Help[19G(B[0;7m^O(B[m Write Out[37G(B[0;7m^W(B[m Where Is[55G(B[0;7m^K(B[m Cut Text[73G(B[0;7m^J(B[m Justify[85;91H(B[0;7m^C(B[m Cur Pos[85;109H(B[0;7mM-U(B[m Undo[85;127H(B[0;7mM-A(B[m Mark Text     (B[0;7mM-](B[m To Bracket    (B[0;7mM-▲(B[m Previous[181G(B[0;7m^B(B[m Back[85;199H(B[0;7m^◀(B[m Prev Word[217G(B[0;7m^A(B[m Home[85;235H(B[0;7m^P(B[m Prev Line[253G(B[0;7mM--(B[m Scroll Up     (B[0;7m^▲(B[m Prev Block     (B[0;7mM-((B[m Beg of Par[86d(B[0;7m^X(B[m Exit[86;19H(B[0;7m^R(B[m Read File[37G(B[0;7m^\(B[m Replace[86;55H(B[0;7m^U(B[m Uncut Text     (B[0;7m^T(B[m To Spell[91G(B[0;7m^_(B[m Go To Line     (B[0;7mM-E(B[m Redo[86;127H(B[0;7mM-6(B[m Copy Text     (B[0;7mM-W(B[m WhereIs Next  (B[0;7mM-▼(B[m Next[86;181H(B[0;7m^F(B[m Forward[86;199H(B[0;7m^▶(B[m Next Word[217G(B[0;7m^E(B[m End[86;235H(B[0;7m^N(B[m Next Line[253G(B[0;7mM-+(B[m Scroll Down   (B[0;7m^▼(B[m Next Block     (B[0;7mM-)(B[m End of Par[84d[3d[39;49m(B[m1) Ethan Blight[?12l[?25h[?25l[3;16H[?12l[?25h[?25l[1;308H(B[0;7mModified(B[m[4d[?12l[?25h[?25l[5d[?12l[?25h[?25l2[?12l[?25h[?25l)[?12l[?25h[?25l [?12l[?25h[?25lH[?12l[?25h[?25lo[?12l[?25h[?25lo[?12l[?25h[?25lb[?12l[?25h[?25l [?12l[?25h[?25l [?12l[?25h[?25lb[?12l[?25h[?25lb[?12l[?25h[?25ly[?12l[?25h[?25l;[?12l[?25h[?25l [?12l[?25h[?25l:[?12l[?25h[?25l [?12l[?25h[?25lP[?12l[?25h[?25lr[?12l[?25h[?25lo[?12l[?25h[?25lg[?12l[?25h[?25lr[?12l[?25h[?25la[?12l[?25h[?25lm[84d[K[5;18H[?12l[?25h[?25lm[?12l[?25h[?25li[?12l[?25h[?25ln[?12l[?25h[?25lg[?12l[?25h[?25l[84d(B[0;7mSave modified buffer?  (Answering "No" will DISCARD changes.)                                                                                                                                                                                                                                                                [85;1H Y(B[m Yes[K[86d(B[0;7m N(B[m No  [86;17H(B[0;7m^C(B[m Cancel[K[84;63H[?12l[?25h[?25l[85d(B[0;7m^G(B[m Get Help[85;80H(B[0;7mM-D(B[m DOS Format[85;159H(B[0;7mM-A(B[m Append[85;238H(B[0;7mM-B(B[m Backup File[86d(B[0;7m^C(B[m Cancel[17G         [86;80H(B[0;7mM-M(B[m Mac Format[86;159H(B[0;7mM-P(B[m Prepend[86;238H(B[0;7m^T(B[m To Files[84d(B[0;7mFile Name to Write: writeup.txt                              (B[m[84;32H[?12l[?25h[?25l[K[1;316H[1;308H(B[0;7m        (B[m[84;151H(B[0;7m[ Wrote 3 lines ](B[m[J[86;317H[?12l[?25h[86;1H[?1049l[23;0;0t[?1l>blighte@cf164-19:~/csci241/lab-1-Ethan-Blight$ girt s[K[K[K[Kty [K[K status
On branch master
Your branch is ahead of 'origin/master' by 1 commit.
  (use "git push" to publish your local commits)

Changes not staged for commit:
  (use "git add <file>..." to update what will be committed)
  (use "git checkout -- <file>..." to discard changes in working directory)

	[31mmodified:   writeup.txt[m

no changes added to commit (use "git add" and/or "git commit -a")
blighte@cf164-19:~/csci241/lab-1-Ethan-Blight$ git add weri[K[K[K[Kwriteup.,rt[K[K[K[K.txt
blighte@cf164-19:~/csci241/lab-1-Ethan-Blight$ git commit -, [K[Km "AS[K[KAdded part 2 (hobby) to the w[K[K[K[K[Kwriteup"
[master 21ce8c1] Added part 2 (hobby) to writeup
 1 file changed, 2 insertions(+)
blighte@cf164-19:~/csci241/lab-1-Ethan-Blight$ git push oeri[K[K[K[Korigin master
Username for 'https://github.com': blighte@wwu.edu
Password for 'https://blighte@wwu.edu@github.com': 
Counting objects: 6, done.
Delta compression using up to 8 threads.
Compressing objects:  25% (1/4)   Compressing objects:  50% (2/4)   Compressing objects:  75% (3/4)   Compressing objects: 100% (4/4)   Compressing objects: 100% (4/4), done.
Writing objects:  16% (1/6)   Writing objects:  33% (2/6)   Writing objects:  50% (3/6)   Writing objects:  66% (4/6)   Writing objects:  83% (5/6)   Writing objects: 100% (6/6)   Writing objects: 100% (6/6), 557 bytes | 185.00 KiB/s, done.
Total 6 (delta 2), reused 0 (delta 0)
remote: Resolving deltas:   0% (0/2)[Kremote: Resolving deltas: 100% (2/2)[Kremote: Resolving deltas: 100% (2/2), completed with 1 local object.[K
To https://github.com/csci241-20s/lab-1-Ethan-Blight
   99ea2e0..21ce8c1  master -> master
blighte@cf164-19:~/csci241/lab-1-Ethan-Blight$ git push origin mastercommit -m "Added part 2 (hobby) to writeup"[1P"[1P"[1P"[1P"[1P"[1P"[1P"[1P"[1P"[1P"[1P"[1P"[1P"[1P"[1P"[1P"[1P"[1P"[1P"[1P"[1P"[1P"[1P"r"t"s" "1" "("n"a"m"e"s")" "a"n"d" "p"a"r"t" "2" "("h"o"b"b"y")" "t"o" "w"r"i"t"e"u"p"[C
On branch master
Your branch is up to date with 'origin/master'.

nothing to commit, working tree clean
blighte@cf164-19:~/csci241/lab-1-Ethan-Blight$ git status
On branch master
Your branch is up to date with 'origin/master'.

nothing to commit, working tree clean
blighte@cf164-19:~/csci241/lab-1-Ethan-Blight$ git push oeri[K[K[Krigin master
Username for 'https://github.com': blighte@qww   wwu.edu
Password for 'https://blighte@wwu.edu@github.com': 
Everything up-to-date
blighte@cf164-19:~/csci241/lab-1-Ethan-Blight$ git status
On branch master
Your branch is up to date with 'origin/master'.

nothing to commit, working tree clean
blighte@cf164-19:~/csci241/lab-1-Ethan-Blight$ touch username.txt
blighte@cf164-19:~/csci241/lab-1-Ethan-Blight$ nano username.tx[Kxt
[?1049h[22;0;0t[1;86r(B[m[4l[?7h[39;49m[?1h=[?1h=[?1h=[?25l[39;49m(B[m[H[2J[84;151H(B[0;7m[ Reading File ](B[m[84;157H(B[0;7m 0 lines ](B[m[H(B[0;7m  GNU nano 2.9.3                                                                                                                                           username.txt                                                                                                                                                      [1;316H(B[m[85d(B[0;7m^G(B[m Get Help[19G(B[0;7m^O(B[m Write Out[37G(B[0;7m^W(B[m Where Is[55G(B[0;7m^K(B[m Cut Text[73G(B[0;7m^J(B[m Justify[85;91H(B[0;7m^C(B[m Cur Pos[85;109H(B[0;7mM-U(B[m Undo[85;127H(B[0;7mM-A(B[m Mark Text     (B[0;7mM-](B[m To Bracket    (B[0;7mM-▲(B[m Previous[181G(B[0;7m^B(B[m Back[85;199H(B[0;7m^◀(B[m Prev Word[217G(B[0;7m^A(B[m Home[85;235H(B[0;7m^P(B[m Prev Line[253G(B[0;7mM--(B[m Scroll Up     (B[0;7m^▲(B[m Prev Block     (B[0;7mM-((B[m Beg of Par[86d(B[0;7m^X(B[m Exit[86;19H(B[0;7m^R(B[m Read File[37G(B[0;7m^\(B[m Replace[86;55H(B[0;7m^U(B[m Uncut Text     (B[0;7m^T(B[m To Spell[91G(B[0;7m^_(B[m Go To Line     (B[0;7mM-E(B[m Redo[86;127H(B[0;7mM-6(B[m Copy Text     (B[0;7mM-W(B[m WhereIs Next  (B[0;7mM-▼(B[m Next[86;181H(B[0;7m^F(B[m Forward[86;199H(B[0;7m^▶(B[m Next Word[217G(B[0;7m^E(B[m End[86;235H(B[0;7m^N(B[m Next Line[253G(B[0;7mM-+(B[m Scroll Down   (B[0;7m^▼(B[m Next Block     (B[0;7mM-)(B[m End of Par[84d[3d[39;49m(B[m[?12l[?25h[?25l[1;308H(B[0;7mModified(B[m[3dE[?12l[?25h[?25lt[?12l[?25h[?25lh[?12l[?25h[?25la[?12l[?25h[?25ln[?12l[?25h[?25l [?12l[?25h[?25lB[?12l[?25h[?25ll[?12l[?25h[?25li[?12l[?25h[?25lg[?12l[?25h[?25lh[?12l[?25h[?25lt[?12l[?25h[?25l,[?12l[?25h[?25l [?12l[?25h[?25lb[?12l[?25h[?25ll[?12l[?25h[?25li[?12l[?25h[?25lg[?12l[?25h[?25lh[?12l[?25h[?25lt[?12l[?25h[?25le[?12l[?25h[?25l,[?12l[?25h[?25l [?12l[?25h[?25lE[?12l[?25h[?25lt[?12l[?25h[?25lh[84d[K[3;27H[?12l[?25h[?25la[?12l[?25h[?25ln[?12l[?25h[?25l-[?12l[?25h[?25lB[?12l[?25h[?25ll[?12l[?25h[?25li[?12l[?25h[?25lg[?12l[?25h[?25lh[?12l[?25h[?25lt[?12l[?25h[?25l[?12l[?25h[?25l[?12l[?25h[?25l[?12l[?25h[?25l[?12l[?25h[?25l[?12l[?25h[?25l[?12l[?25h[?25l[?12l[?25h[?25l[?12l[?25h[?25l[?12l[?25h[?25l[?12l[?25h[?25l[?12l[?25h[?25l[?12l[?25h[?25l[1P[?12l[?25h[?25l[?12l[?25h[?25l[?12l[?25h[?25l[?12l[?25h[?25l[?12l[?25h[?25l[?12l[?25h[?25l[?12l[?25h[?25l[?12l[?25h[?25l[?12l[?25h[?25l[1P[?12l[?25h[?25lb[?12l[?25h[?25ll[?12l[?25h[?25li[?12l[?25h[?25lg[?12l[?25h[?25lh[?12l[?25h[?25lt[?12l[?25h[?25le[?12l[?25h[?25l,[?12l[?25h[?25lE[?12l[?25h[?25lt[?12l[?25h[?25lh[?12l[?25h[?25la[?12l[?25h[?25ln[?12l[?25h[?25l-[?12l[?25h[?25lB[?12l[?25h[?25ll[?12l[?25h[?25li[?12l[?25h[?25lg[?12l[?25h[?25lh[?12l[?25h[?25lt[?12l[?25h[?25l[4d[?12l[?25h[?25l[?12l[?25h[?25l[?12l[?25h[?25l[?12l[?25h[?25l[3;34H[?12l[?25h[?25l[84d(B[0;7mSave modified buffer?  (Answering "No" will DISCARD changes.)                                                                                                                                                                                                                                                                [85;1H Y(B[m Yes[K[86d(B[0;7m N(B[m No  [86;17H(B[0;7m^C(B[m Cancel[K[84;63H[?12l[?25h[?25l[85d(B[0;7m^G(B[m Get Help[85;80H(B[0;7mM-D(B[m DOS Format[85;159H(B[0;7mM-A(B[m Append[85;238H(B[0;7mM-B(B[m Backup File[86d(B[0;7m^C(B[m Cancel[17G         [86;80H(B[0;7mM-M(B[m Mac Format[86;159H(B[0;7mM-P(B[m Prepend[86;238H(B[0;7m^T(B[m To Files[84d(B[0;7mFile Name to Write: username.txt                             (B[m[84;33H[?12l[?25h[?25l[K[1;316H[1;308H(B[0;7m        (B[m[84;151H(B[0;7m[ Wrote 1 line ](B[m[J[86;317H[?12l[?25h[86;1H[?1049l[23;0;0t[?1l>blighte@cf164-19:~/csci241/lab-1-Ethan-Blight$ git commit -m "Added[K[K[K[K[K[K[K[K[K[K[K[K[K[K[K[Kadd userna,me[K[K[Kme.txt
blighte@cf164-19:~/csci241/lab-1-Ethan-Blight$ git commit -m Z"[K[K"Added first and lkas[K[K[K[Klast name, WWU User[K[K[K[Kuserna,e and [K[K[K[K[K[K[Kme, and Giut[K[KtHbu[K[Kub username to username.txt[K[K[K[K.txt"
[master daf0dfc] Added first and last name, WWU username, and GitHub username to username.txt
 1 file changed, 1 insertion(+)
 create mode 100644 username.txt
blighte@cf164-19:~/csci241/lab-1-Ethan-Blight$ git push origin master
Username for 'https://github.com': blighte@wwu,.e   .edu
Password for 'https://blighte@wwu.edu@github.com': 
Counting objects: 3, done.
Delta compression using up to 8 threads.
Compressing objects:  50% (1/2)   Compressing objects: 100% (2/2)   Compressing objects: 100% (2/2), done.
Writing objects:  33% (1/3)   Writing objects:  66% (2/3)   Writing objects: 100% (3/3)   Writing objects: 100% (3/3), 336 bytes | 336.00 KiB/s, done.
Total 3 (delta 1), reused 0 (delta 0)
remote: Resolving deltas:   0% (0/1)[Kremote: Resolving deltas: 100% (1/1)[Kremote: Resolving deltas: 100% (1/1), completed with 1 local object.[K
To https://github.com/csci241-20s/lab-1-Ethan-Blight
   21ce8c1..daf0dfc  master -> master
blighte@cf164-19:~/csci241/lab-1-Ethan-Blight$ git checkout
Your branch is up to date with 'origin/master'.
blighte@cf164-19:~/csci241/lab-1-Ethan-Blight$ git reset
blighte@cf164-19:~/csci241/lab-1-Ethan-Blight$ nano username,.t[K[K[K.txt
[?1049h[22;0;0t[1;86r(B[m[4l[?7h[39;49m[?1h=[?1h=[?1h=[?25l[39;49m(B[m[H[2J[84;151H(B[0;7m[ Reading File ](B[m[84;151H (B[0;7m[ Read 1 line ](B[m[H(B[0;7m  GNU nano 2.9.3                                                                                                                                           username.txt                                                                                                                                                      [1;316H(B[m[85d(B[0;7m^G(B[m Get Help[19G(B[0;7m^O(B[m Write Out[37G(B[0;7m^W(B[m Where Is[55G(B[0;7m^K(B[m Cut Text[73G(B[0;7m^J(B[m Justify[85;91H(B[0;7m^C(B[m Cur Pos[85;109H(B[0;7mM-U(B[m Undo[85;127H(B[0;7mM-A(B[m Mark Text     (B[0;7mM-](B[m To Bracket    (B[0;7mM-▲(B[m Previous[181G(B[0;7m^B(B[m Back[85;199H(B[0;7m^◀(B[m Prev Word[217G(B[0;7m^A(B[m Home[85;235H(B[0;7m^P(B[m Prev Line[253G(B[0;7mM--(B[m Scroll Up     (B[0;7m^▲(B[m Prev Block     (B[0;7mM-((B[m Beg of Par[86d(B[0;7m^X(B[m Exit[86;19H(B[0;7m^R(B[m Read File[37G(B[0;7m^\(B[m Replace[86;55H(B[0;7m^U(B[m Uncut Text     (B[0;7m^T(B[m To Spell[91G(B[0;7m^_(B[m Go To Line     (B[0;7mM-E(B[m Redo[86;127H(B[0;7mM-6(B[m Copy Text     (B[0;7mM-W(B[m WhereIs Next  (B[0;7mM-▼(B[m Next[86;181H(B[0;7m^F(B[m Forward[86;199H(B[0;7m^▶(B[m Next Word[217G(B[0;7m^E(B[m End[86;235H(B[0;7m^N(B[m Next Line[253G(B[0;7mM-+(B[m Scroll Down   (B[0;7m^▼(B[m Next Block     (B[0;7mM-)(B[m End of Par[84d[3d[39;49m(B[mEthan Blight,blighte,Ethan-Blight[?12l[?25h[?25l[84d[J[86;317H[?12l[?25h[86;1H[?1049l[23;0;0t[?1l>blighte@cf164-19:~/csci241/lab-1-Ethan-Blight$ touch test.txt
blighte@cf164-19:~/csci241/lab-1-Ethan-Blight$ nano test.txt
[?1049h[22;0;0t[1;86r(B[m[4l[?7h[39;49m[?1h=[?1h=[?1h=[?25l[39;49m(B[m[H[2J[84;151H(B[0;7m[ Reading File ](B[m[84;157H(B[0;7m 0 lines ](B[m[H(B[0;7m  GNU nano 2.9.3                                                                                                                                             test.txt                                                                                                                                                        [1;316H(B[m[85d(B[0;7m^G(B[m Get Help[19G(B[0;7m^O(B[m Write Out[37G(B[0;7m^W(B[m Where Is[55G(B[0;7m^K(B[m Cut Text[73G(B[0;7m^J(B[m Justify[85;91H(B[0;7m^C(B[m Cur Pos[85;109H(B[0;7mM-U(B[m Undo[85;127H(B[0;7mM-A(B[m Mark Text     (B[0;7mM-](B[m To Bracket    (B[0;7mM-▲(B[m Previous[181G(B[0;7m^B(B[m Back[85;199H(B[0;7m^◀(B[m Prev Word[217G(B[0;7m^A(B[m Home[85;235H(B[0;7m^P(B[m Prev Line[253G(B[0;7mM--(B[m Scroll Up     (B[0;7m^▲(B[m Prev Block     (B[0;7mM-((B[m Beg of Par[86d(B[0;7m^X(B[m Exit[86;19H(B[0;7m^R(B[m Read File[37G(B[0;7m^\(B[m Replace[86;55H(B[0;7m^U(B[m Uncut Text     (B[0;7m^T(B[m To Spell[91G(B[0;7m^_(B[m Go To Line     (B[0;7mM-E(B[m Redo[86;127H(B[0;7mM-6(B[m Copy Text     (B[0;7mM-W(B[m WhereIs Next  (B[0;7mM-▼(B[m Next[86;181H(B[0;7m^F(B[m Forward[86;199H(B[0;7m^▶(B[m Next Word[217G(B[0;7m^E(B[m End[86;235H(B[0;7m^N(B[m Next Line[253G(B[0;7mM-+(B[m Scroll Down   (B[0;7m^▼(B[m Next Block     (B[0;7mM-)(B[m End of Par[84d[3d[39;49m(B[m[?12l[?25h[?25l[1;308H(B[0;7mModified(B[m[3dt[?12l[?25h[?25le[?12l[?25h[?25ls[?12l[?25h[?25lt[?12l[?25h[?25l [?12l[?25h[?25lt[?12l[?25h[?25le[?12l[?25h[?25lx[?12l[?25h[?25lt[?12l[?25h[?25l[84d(B[0;7mSave modified buffer?  (Answering "No" will DISCARD changes.)                                                                                                                                                                                                                                                                [85;1H Y(B[m Yes[K[86d(B[0;7m N(B[m No  [86;17H(B[0;7m^C(B[m Cancel[K[84;63H[?12l[?25h[?25l[85d(B[0;7m^G(B[m Get Help[85;80H(B[0;7mM-D(B[m DOS Format[85;159H(B[0;7mM-A(B[m Append[85;238H(B[0;7mM-B(B[m Backup File[86d(B[0;7m^C(B[m Cancel[17G         [86;80H(B[0;7mM-M(B[m Mac Format[86;159H(B[0;7mM-P(B[m Prepend[86;238H(B[0;7m^T(B[m To Files[84d(B[0;7mFile Name to Write: test.txt                                 (B[m[84;29H[?12l[?25h[?25l[K[1;316H[1;308H(B[0;7m        (B[m[84;151H(B[0;7m[ Wrote 1 line ](B[m[J[86;317H[?12l[?25h[86;1H[?1049l[23;0;0t[?1l>blighte@cf164-19:~/csci241/lab-1-Ethan-Blight$ 
blighte@cf164-19:~/csci241/lab-1-Ethan-Blight$ 
blighte@cf164-19:~/csci241/lab-1-Ethan-Blight$ git check9ut[K[K[Kout
Your branch is up to date with 'origin/master'.
blighte@cf164-19:~/csci241/lab-1-Ethan-Blight$ git reset
blighte@cf164-19:~/csci241/lab-1-Ethan-Blight$ git resetcheckoutnano test.txt
[?1049h[22;0;0t[1;86r(B[m[4l[?7h[39;49m[?1h=[?1h=[?1h=[?25l[39;49m(B[m[H[2J[84;151H(B[0;7m[ Reading File ](B[m[84;151H (B[0;7m[ Read 1 line ](B[m[H(B[0;7m  GNU nano 2.9.3                                                                                                                                             test.txt                                                                                                                                                        [1;316H(B[m[85d(B[0;7m^G(B[m Get Help[19G(B[0;7m^O(B[m Write Out[37G(B[0;7m^W(B[m Where Is[55G(B[0;7m^K(B[m Cut Text[73G(B[0;7m^J(B[m Justify[85;91H(B[0;7m^C(B[m Cur Pos[85;109H(B[0;7mM-U(B[m Undo[85;127H(B[0;7mM-A(B[m Mark Text     (B[0;7mM-](B[m To Bracket    (B[0;7mM-▲(B[m Previous[181G(B[0;7m^B(B[m Back[85;199H(B[0;7m^◀(B[m Prev Word[217G(B[0;7m^A(B[m Home[85;235H(B[0;7m^P(B[m Prev Line[253G(B[0;7mM--(B[m Scroll Up     (B[0;7m^▲(B[m Prev Block     (B[0;7mM-((B[m Beg of Par[86d(B[0;7m^X(B[m Exit[86;19H(B[0;7m^R(B[m Read File[37G(B[0;7m^\(B[m Replace[86;55H(B[0;7m^U(B[m Uncut Text     (B[0;7m^T(B[m To Spell[91G(B[0;7m^_(B[m Go To Line     (B[0;7mM-E(B[m Redo[86;127H(B[0;7mM-6(B[m Copy Text     (B[0;7mM-W(B[m WhereIs Next  (B[0;7mM-▼(B[m Next[86;181H(B[0;7m^F(B[m Forward[86;199H(B[0;7m^▶(B[m Next Word[217G(B[0;7m^E(B[m End[86;235H(B[0;7m^N(B[m Next Line[253G(B[0;7mM-+(B[m Scroll Down   (B[0;7m^▼(B[m Next Block     (B[0;7mM-)(B[m End of Par[84d[3d[39;49m(B[mtest text[?12l[?25h[?25l[84d[J[86;317H[?12l[?25h[86;1H[?1049l[23;0;0t[?1l>blighte@cf164-19:~/csci241/lab-1-Ethan-Blight$ goit [K[K[K[Kit help reset
[?1049h[22;0;0t[?1h=GIT-RESET(1)                                                                                                                                          Git Manual                                                                                                                                         GIT-RESET(1)[m
[m
[1mNAME[0m[m
       git-reset - Reset current HEAD to the specified state[m
[m
[1mSYNOPSIS[0m[m
       [4mgit[24m [4mreset[24m [-q] [<tree-ish>] [--] <paths>...[m
       [4mgit[24m [4mreset[24m (--patch | -p) [<tree-ish>] [--] [<paths>...][m
       [4mgit[24m [4mreset[24m [--soft | --mixed [-N] | --hard | --merge | --keep] [-q] [<commit>][m
[m
[1mDESCRIPTION[0m[m
       In the first and second form, copy entries from <tree-ish> to the index. In the third form, set the current branch head (HEAD) to <commit>, optionally modifying index and working tree to match. The <tree-ish>/<commit> defaults to HEAD in all forms.[m
[m
       [4mgit[24m [4mreset[24m [-q] [<tree-ish>] [--] <paths>...[m
           This form resets the index entries for all <paths> to their state at <tree-ish>. (It does not affect the working tree or the current branch.)[m
[m
           This means that [1mgit[0m [1mreset[0m [1m<paths>[0m is the opposite of [1mgit[0m [1madd[0m [1m<paths>[0m.[m
[m
           After running [1mgit[0m [1mreset[0m [1m<paths>[0m to update the index entry, you can use [1mgit-checkout[0m(1) to check the contents out of the index to the working tree. Alternatively, using [1mgit-checkout[0m(1) and specifying a commit, you can copy the contents of a path out of a commit to the index and to the working tree[m
           in one go.[m
[m
       [4mgit[24m [4mreset[24m (--patch | -p) [<tree-ish>] [--] [<paths>...][m
           Interactively select hunks in the difference between the index and <tree-ish> (defaults to HEAD). The chosen hunks are applied in reverse to the index.[m
[m
           This means that [1mgit[0m [1mreset[0m [1m-p[0m is the opposite of [1mgit[0m [1madd[0m [1m-p[0m, i.e. you can use it to selectively reset hunks. See the “Interactive Mode” section of [1mgit-add[0m(1) to learn how to operate the [1m--patch[0m mode.[m
[m
       [4mgit[24m [4mreset[24m [<mode>] [<commit>][m
           This form resets the current branch head to <commit> and possibly updates the index (resetting it to the tree of <commit>) and the working tree depending on <mode>. If <mode> is omitted, defaults to "--mixed". The <mode> must be one of the following:[m
[m
           --soft[m
               Does not touch the index file or the working tree at all (but resets the head to <commit>, just like all modes do). This leaves all your changed files "Changes to be committed", as [4mgit[24m [4mstatus[24m would put it.[m
[m
           --mixed[m
               Resets the index but not the working tree (i.e., the changed files are preserved but not marked for commit) and reports what has not been updated. This is the default action.[m
[m
               If [1m-N[0m is specified, removed paths are marked as intent-to-add (see [1mgit-add[0m(1)).[m
[m
           --hard[m
               Resets the index and working tree. Any changes to tracked files in the working tree since <commit> are discarded.[m
[m
           --merge[m
               Resets the index and updates the files in the working tree that are different between <commit> and HEAD, but keeps those which are different between the index and working tree (i.e. which have changes which have not been added). If a file that is different between <commit> and the index has[m
               unstaged changes, reset is aborted.[m
[m
               In other words, --merge does something like a [4mgit[24m [4mread-tree[24m [4m-u[24m [4m-m[24m [4m<commit>[24m, but carries forward unmerged index entries.[m
[m
           --keep[m
               Resets index entries and updates files in the working tree that are different between <commit> and HEAD. If a file that is different between <commit> and HEAD has local changes, reset is aborted.[m
[m
       If you want to undo a commit other than the latest on a branch, [1mgit-revert[0m(1) is your friend.[m
[m
[1mOPTIONS[0m[m
       -q, --quiet[m
           Be quiet, only report errors.[m
[m
[1mEXAMPLES[0m[m
       Undo add[m
[m
               $ edit                                     [1m(1)[0m[m
               $ git add frotz.c filfre.c[m
               $ mailx                                    [1m(2)[0m[m
               $ git reset                                [1m(3)[0m[m
               $ git pull git://info.example.com/ nitfol  [1m(4)[0m[m
[m
           [1m1.[0m You are happily working on something, and find the changes in these files are in good order. You do not want to see them when you run "git diff", because you plan to work on other files and changes with these files are distracting.[m
           [1m2.[0m Somebody asks you to pull, and the changes sound worthy of merging.[m
           [1m3.[0m However, you already dirtied the index (i.e. your index does not match the HEAD commit). But you know the pull you are going to make does not affect frotz.c or filfre.c, so you revert the index changes for these two files. Your changes in working tree remain there.[m
           [1m4.[0m Then you can pull and merge, leaving frotz.c and filfre.c changes still in the working tree.[m
[m
       Undo a commit and redo[m
[m
               $ git commit ...[m
               $ git reset --soft HEAD^      [1m(1)[0m[m
               $ edit                        [1m(2)[0m[m
               $ git commit -a -c ORIG_HEAD  [1m(3)[0m[m
[m
           [1m1.[0m This is most often done when you remembered what you just committed is incomplete, or you misspelled your commit message, or both. Leaves working tree as it was before "reset".[m
           [1m2.[0m Make corrections to working tree files.[m
           [1m3.[0m "reset" copies the old head to .git/ORIG_HEAD; redo the commit by starting with its log message. If you do not need to edit the message further, you can give -C option instead.[m
[m
           See also the --amend option to [1mgit-commit[0m(1).[m
[m
       Undo a commit, making it a topic branch[m
[m
               $ git branch topic/wip     [1m(1)[0m[m
[7m Manual page git-reset(1) line 1 (press h for help or q to quit)[27m[K[K[?1l>[?1049l[23;0;0tblighte@cf164-19:~/csci241/lab-1-Ethan-Blight$ git[K[K[K
blighte@cf164-19:~/csci241/lab-1-Ethan-Blight$ git reset rt[K[Ktext.tst[K[K[K[K[K[Ksd[K[Kst.txt
blighte@cf164-19:~/csci241/lab-1-Ethan-Blight$ nano test.txt
[?1049h[22;0;0t[1;86r(B[m[4l[?7h[39;49m[?1h=[?1h=[?1h=[?25l[39;49m(B[m[H[2J[84;151H(B[0;7m[ Reading File ](B[m[84;151H (B[0;7m[ Read 1 line ](B[m[H(B[0;7m  GNU nano 2.9.3                                                                                                                                             test.txt                                                                                                                                                        [1;316H(B[m[85d(B[0;7m^G(B[m Get Help[19G(B[0;7m^O(B[m Write Out[37G(B[0;7m^W(B[m Where Is[55G(B[0;7m^K(B[m Cut Text[73G(B[0;7m^J(B[m Justify[85;91H(B[0;7m^C(B[m Cur Pos[85;109H(B[0;7mM-U(B[m Undo[85;127H(B[0;7mM-A(B[m Mark Text     (B[0;7mM-](B[m To Bracket    (B[0;7mM-▲(B[m Previous[181G(B[0;7m^B(B[m Back[85;199H(B[0;7m^◀(B[m Prev Word[217G(B[0;7m^A(B[m Home[85;235H(B[0;7m^P(B[m Prev Line[253G(B[0;7mM--(B[m Scroll Up     (B[0;7m^▲(B[m Prev Block     (B[0;7mM-((B[m Beg of Par[86d(B[0;7m^X(B[m Exit[86;19H(B[0;7m^R(B[m Read File[37G(B[0;7m^\(B[m Replace[86;55H(B[0;7m^U(B[m Uncut Text     (B[0;7m^T(B[m To Spell[91G(B[0;7m^_(B[m Go To Line     (B[0;7mM-E(B[m Redo[86;127H(B[0;7mM-6(B[m Copy Text     (B[0;7mM-W(B[m WhereIs Next  (B[0;7mM-▼(B[m Next[86;181H(B[0;7m^F(B[m Forward[86;199H(B[0;7m^▶(B[m Next Word[217G(B[0;7m^E(B[m End[86;235H(B[0;7m^N(B[m Next Line[253G(B[0;7mM-+(B[m Scroll Down   (B[0;7m^▼(B[m Next Block     (B[0;7mM-)(B[m End of Par[84d[3d[39;49m(B[mtest text[?12l[?25h[?25l[84d[J[86;317H[?12l[?25h[86;1H[?1049l[23;0;0t[?1l>blighte@cf164-19:~/csci241/lab-1-Ethan-Blight$ nano test.txt[5@git reset[C[C[C[C[C[C[C[C[C[4Phelp reset
[?1049h[22;0;0t[?1h=GIT-RESET(1)                                                                                                                                          Git Manual                                                                                                                                         GIT-RESET(1)[m
[m
[1mNAME[0m[m
       git-reset - Reset current HEAD to the specified state[m
[m
[1mSYNOPSIS[0m[m
       [4mgit[24m [4mreset[24m [-q] [<tree-ish>] [--] <paths>...[m
       [4mgit[24m [4mreset[24m (--patch | -p) [<tree-ish>] [--] [<paths>...][m
       [4mgit[24m [4mreset[24m [--soft | --mixed [-N] | --hard | --merge | --keep] [-q] [<commit>][m
[m
[1mDESCRIPTION[0m[m
       In the first and second form, copy entries from <tree-ish> to the index. In the third form, set the current branch head (HEAD) to <commit>, optionally modifying index and working tree to match. The <tree-ish>/<commit> defaults to HEAD in all forms.[m
[m
       [4mgit[24m [4mreset[24m [-q] [<tree-ish>] [--] <paths>...[m
           This form resets the index entries for all <paths> to their state at <tree-ish>. (It does not affect the working tree or the current branch.)[m
[m
           This means that [1mgit[0m [1mreset[0m [1m<paths>[0m is the opposite of [1mgit[0m [1madd[0m [1m<paths>[0m.[m
[m
           After running [1mgit[0m [1mreset[0m [1m<paths>[0m to update the index entry, you can use [1mgit-checkout[0m(1) to check the contents out of the index to the working tree. Alternatively, using [1mgit-checkout[0m(1) and specifying a commit, you can copy the contents of a path out of a commit to the index and to the working tree[m
           in one go.[m
[m
       [4mgit[24m [4mreset[24m (--patch | -p) [<tree-ish>] [--] [<paths>...][m
           Interactively select hunks in the difference between the index and <tree-ish> (defaults to HEAD). The chosen hunks are applied in reverse to the index.[m
[m
           This means that [1mgit[0m [1mreset[0m [1m-p[0m is the opposite of [1mgit[0m [1madd[0m [1m-p[0m, i.e. you can use it to selectively reset hunks. See the “Interactive Mode” section of [1mgit-add[0m(1) to learn how to operate the [1m--patch[0m mode.[m
[m
       [4mgit[24m [4mreset[24m [<mode>] [<commit>][m
           This form resets the current branch head to <commit> and possibly updates the index (resetting it to the tree of <commit>) and the working tree depending on <mode>. If <mode> is omitted, defaults to "--mixed". The <mode> must be one of the following:[m
[m
           --soft[m
               Does not touch the index file or the working tree at all (but resets the head to <commit>, just like all modes do). This leaves all your changed files "Changes to be committed", as [4mgit[24m [4mstatus[24m would put it.[m
[m
           --mixed[m
               Resets the index but not the working tree (i.e., the changed files are preserved but not marked for commit) and reports what has not been updated. This is the default action.[m
[m
               If [1m-N[0m is specified, removed paths are marked as intent-to-add (see [1mgit-add[0m(1)).[m
[m
           --hard[m
               Resets the index and working tree. Any changes to tracked files in the working tree since <commit> are discarded.[m
[m
           --merge[m
               Resets the index and updates the files in the working tree that are different between <commit> and HEAD, but keeps those which are different between the index and working tree (i.e. which have changes which have not been added). If a file that is different between <commit> and the index has[m
               unstaged changes, reset is aborted.[m
[m
               In other words, --merge does something like a [4mgit[24m [4mread-tree[24m [4m-u[24m [4m-m[24m [4m<commit>[24m, but carries forward unmerged index entries.[m
[m
           --keep[m
               Resets index entries and updates files in the working tree that are different between <commit> and HEAD. If a file that is different between <commit> and HEAD has local changes, reset is aborted.[m
[m
       If you want to undo a commit other than the latest on a branch, [1mgit-revert[0m(1) is your friend.[m
[m
[1mOPTIONS[0m[m
       -q, --quiet[m
           Be quiet, only report errors.[m
[m
[1mEXAMPLES[0m[m
       Undo add[m
[m
               $ edit                                     [1m(1)[0m[m
               $ git add frotz.c filfre.c[m
               $ mailx                                    [1m(2)[0m[m
               $ git reset                                [1m(3)[0m[m
               $ git pull git://info.example.com/ nitfol  [1m(4)[0m[m
[m
           [1m1.[0m You are happily working on something, and find the changes in these files are in good order. You do not want to see them when you run "git diff", because you plan to work on other files and changes with these files are distracting.[m
           [1m2.[0m Somebody asks you to pull, and the changes sound worthy of merging.[m
           [1m3.[0m However, you already dirtied the index (i.e. your index does not match the HEAD commit). But you know the pull you are going to make does not affect frotz.c or filfre.c, so you revert the index changes for these two files. Your changes in working tree remain there.[m
           [1m4.[0m Then you can pull and merge, leaving frotz.c and filfre.c changes still in the working tree.[m
[m
       Undo a commit and redo[m
[m
               $ git commit ...[m
               $ git reset --soft HEAD^      [1m(1)[0m[m
               $ edit                        [1m(2)[0m[m
               $ git commit -a -c ORIG_HEAD  [1m(3)[0m[m
[m
           [1m1.[0m This is most often done when you remembered what you just committed is incomplete, or you misspelled your commit message, or both. Leaves working tree as it was before "reset".[m
           [1m2.[0m Make corrections to working tree files.[m
           [1m3.[0m "reset" copies the old head to .git/ORIG_HEAD; redo the commit by starting with its log message. If you do not need to edit the message further, you can give -C option instead.[m
[m
           See also the --amend option to [1mgit-commit[0m(1).[m
[m
       Undo a commit, making it a topic branch[m
[m
               $ git branch topic/wip     [1m(1)[0m[m
[7m Manual page git-reset(1) line 1 (press h for help or q to quit)[27m[K[K[?1l>[?1049l[23;0;0tblighte@cf164-19:~/csci241/lab-1-Ethan-Blight$ git checkout test.txt
error: pathspec 'test.txt' did not match any file(s) known to git.
blighte@cf164-19:~/csci241/lab-1-Ethan-Blight$ git checkout test.txt.test.txt\test.txt
error: pathspec '.test.txt' did not match any file(s) known to git.
blighte@cf164-19:~/csci241/lab-1-Ethan-Blight$ git checkout master
Already on 'master'
Your branch is up to date with 'origin/master'.
blighte@cf164-19:~/csci241/lab-1-Ethan-Blight$ git checkout remote
error: pathspec 'remote' did not match any file(s) known to git.
blighte@cf164-19:~/csci241/lab-1-Ethan-Blight$ git checkout -- tex[Kst.txt
error: pathspec 'test.txt' did not match any file(s) known to git.
blighte@cf164-19:~/csci241/lab-1-Ethan-Blight$ git checkout -- test.txt[K[K[K[K
error: pathspec 'test' did not match any file(s) known to git.
blighte@cf164-19:~/csci241/lab-1-Ethan-Blight$ git reset HEAD file[K[K[K[Ktest.txt
blighte@cf164-19:~/csci241/lab-1-Ethan-Blight$ git reset HEAD test.txt[3Pcheckout -- test.txt[5Premotemaster.\test.txt[2Ptest.txt[7Phelp reset[K[K[K[K[K[K[K[K[K[K[K[K[K[Knano test.txt
[?1049h[22;0;0t[1;86r(B[m[4l[?7h[39;49m[?1h=[?1h=[?1h=[?25l[39;49m(B[m[H[2J[84;151H(B[0;7m[ Reading File ](B[m[84;151H (B[0;7m[ Read 1 line ](B[m[H(B[0;7m  GNU nano 2.9.3                                                                                                                                             test.txt                                                                                                                                                        [1;316H(B[m[85d(B[0;7m^G(B[m Get Help[19G(B[0;7m^O(B[m Write Out[37G(B[0;7m^W(B[m Where Is[55G(B[0;7m^K(B[m Cut Text[73G(B[0;7m^J(B[m Justify[85;91H(B[0;7m^C(B[m Cur Pos[85;109H(B[0;7mM-U(B[m Undo[85;127H(B[0;7mM-A(B[m Mark Text     (B[0;7mM-](B[m To Bracket    (B[0;7mM-▲(B[m Previous[181G(B[0;7m^B(B[m Back[85;199H(B[0;7m^◀(B[m Prev Word[217G(B[0;7m^A(B[m Home[85;235H(B[0;7m^P(B[m Prev Line[253G(B[0;7mM--(B[m Scroll Up     (B[0;7m^▲(B[m Prev Block     (B[0;7mM-((B[m Beg of Par[86d(B[0;7m^X(B[m Exit[86;19H(B[0;7m^R(B[m Read File[37G(B[0;7m^\(B[m Replace[86;55H(B[0;7m^U(B[m Uncut Text     (B[0;7m^T(B[m To Spell[91G(B[0;7m^_(B[m Go To Line     (B[0;7mM-E(B[m Redo[86;127H(B[0;7mM-6(B[m Copy Text     (B[0;7mM-W(B[m WhereIs Next  (B[0;7mM-▼(B[m Next[86;181H(B[0;7m^F(B[m Forward[86;199H(B[0;7m^▶(B[m Next Word[217G(B[0;7m^E(B[m End[86;235H(B[0;7m^N(B[m Next Line[253G(B[0;7mM-+(B[m Scroll Down   (B[0;7m^▼(B[m Next Block     (B[0;7mM-)(B[m End of Par[84d[3d[39;49m(B[mtest text[?12l[?25h[?25l[84d[J[86;317H[?12l[?25h[86;1H[?1049l[23;0;0t[?1l>blighte@cf164-19:~/csci241/lab-1-Ethan-Blight$ git checkout username.txt[C username.txt- username.txt- username.txt
blighte@cf164-19:~/csci241/lab-1-Ethan-Blight$ git[K[K[Knano username.txt
[?1049h[22;0;0t[1;86r(B[m[4l[?7h[39;49m[?1h=[?1h=[?1h=[?25l[39;49m(B[m[H[2J[84;151H(B[0;7m[ Reading File ](B[m[84;151H (B[0;7m[ Read 1 line ](B[m[H(B[0;7m  GNU nano 2.9.3                                                                                                                                           username.txt                                                                                                                                                      [1;316H(B[m[85d(B[0;7m^G(B[m Get Help[19G(B[0;7m^O(B[m Write Out[37G(B[0;7m^W(B[m Where Is[55G(B[0;7m^K(B[m Cut Text[73G(B[0;7m^J(B[m Justify[85;91H(B[0;7m^C(B[m Cur Pos[85;109H(B[0;7mM-U(B[m Undo[85;127H(B[0;7mM-A(B[m Mark Text     (B[0;7mM-](B[m To Bracket    (B[0;7mM-▲(B[m Previous[181G(B[0;7m^B(B[m Back[85;199H(B[0;7m^◀(B[m Prev Word[217G(B[0;7m^A(B[m Home[85;235H(B[0;7m^P(B[m Prev Line[253G(B[0;7mM--(B[m Scroll Up     (B[0;7m^▲(B[m Prev Block     (B[0;7mM-((B[m Beg of Par[86d(B[0;7m^X(B[m Exit[86;19H(B[0;7m^R(B[m Read File[37G(B[0;7m^\(B[m Replace[86;55H(B[0;7m^U(B[m Uncut Text     (B[0;7m^T(B[m To Spell[91G(B[0;7m^_(B[m Go To Line     (B[0;7mM-E(B[m Redo[86;127H(B[0;7mM-6(B[m Copy Text     (B[0;7mM-W(B[m WhereIs Next  (B[0;7mM-▼(B[m Next[86;181H(B[0;7m^F(B[m Forward[86;199H(B[0;7m^▶(B[m Next Word[217G(B[0;7m^E(B[m End[86;235H(B[0;7m^N(B[m Next Line[253G(B[0;7mM-+(B[m Scroll Down   (B[0;7m^▼(B[m Next Block     (B[0;7mM-)(B[m End of Par[84d[3d[39;49m(B[mEthan Blight,blighte,Ethan-Blight[?12l[?25h[?25l[84d[J[86;317H[?12l[?25h[86;1H[?1049l[23;0;0t[?1l>blighte@cf164-19:~/csci241/lab-1-Ethan-Blight$ git reset nano username.txt[11@git checkout --[C[C[C[C[C[C[C[C[C[C[C[C[C[1P username.txt[1P username.txt[1Pusername.txt
blighte@cf164-19:~/csci241/lab-1-Ethan-Blight$ git checkout username.txt[8Pnano[C[C[C[C[C[C[C[C[C[C[C[C[C
[?1049h[22;0;0t[1;86r(B[m[4l[?7h[39;49m[?1h=[?1h=[?1h=[?25l[39;49m(B[m[H[2J[84;151H(B[0;7m[ Reading File ](B[m[84;151H (B[0;7m[ Read 1 line ](B[m[H(B[0;7m  GNU nano 2.9.3                                                                                                                                           username.txt                                                                                                                                                      [1;316H(B[m[85d(B[0;7m^G(B[m Get Help[19G(B[0;7m^O(B[m Write Out[37G(B[0;7m^W(B[m Where Is[55G(B[0;7m^K(B[m Cut Text[73G(B[0;7m^J(B[m Justify[85;91H(B[0;7m^C(B[m Cur Pos[85;109H(B[0;7mM-U(B[m Undo[85;127H(B[0;7mM-A(B[m Mark Text     (B[0;7mM-](B[m To Bracket    (B[0;7mM-▲(B[m Previous[181G(B[0;7m^B(B[m Back[85;199H(B[0;7m^◀(B[m Prev Word[217G(B[0;7m^A(B[m Home[85;235H(B[0;7m^P(B[m Prev Line[253G(B[0;7mM--(B[m Scroll Up     (B[0;7m^▲(B[m Prev Block     (B[0;7mM-((B[m Beg of Par[86d(B[0;7m^X(B[m Exit[86;19H(B[0;7m^R(B[m Read File[37G(B[0;7m^\(B[m Replace[86;55H(B[0;7m^U(B[m Uncut Text     (B[0;7m^T(B[m To Spell[91G(B[0;7m^_(B[m Go To Line     (B[0;7mM-E(B[m Redo[86;127H(B[0;7mM-6(B[m Copy Text     (B[0;7mM-W(B[m WhereIs Next  (B[0;7mM-▼(B[m Next[86;181H(B[0;7m^F(B[m Forward[86;199H(B[0;7m^▶(B[m Next Word[217G(B[0;7m^E(B[m End[86;235H(B[0;7m^N(B[m Next Line[253G(B[0;7mM-+(B[m Scroll Down   (B[0;7m^▼(B[m Next Block     (B[0;7mM-)(B[m End of Par[84d[3d[39;49m(B[mEthan Blight,blighte,Ethan-Blight[?12l[?25h[?25l[84d[J[86;317H[?12l[?25h[86;1H[?1049l[23;0;0t[?1l>blighte@cf164-19:~/csci241/lab-1-Ethan-Blight$ git resrt[K[Ket --hard test.txt
fatal: Cannot do hard reset with paths.
blighte@cf164-19:~/csci241/lab-1-Ethan-Blight$ git help reset
[?1049h[22;0;0t[?1h=GIT-RESET(1)                                                                                                                                          Git Manual                                                                                                                                         GIT-RESET(1)[m
[m
[1mNAME[0m[m
       git-reset - Reset current HEAD to the specified state[m
[m
[1mSYNOPSIS[0m[m
       [4mgit[24m [4mreset[24m [-q] [<tree-ish>] [--] <paths>...[m
       [4mgit[24m [4mreset[24m (--patch | -p) [<tree-ish>] [--] [<paths>...][m
       [4mgit[24m [4mreset[24m [--soft | --mixed [-N] | --hard | --merge | --keep] [-q] [<commit>][m
[m
[1mDESCRIPTION[0m[m
       In the first and second form, copy entries from <tree-ish> to the index. In the third form, set the current branch head (HEAD) to <commit>, optionally modifying index and working tree to match. The <tree-ish>/<commit> defaults to HEAD in all forms.[m
[m
       [4mgit[24m [4mreset[24m [-q] [<tree-ish>] [--] <paths>...[m
           This form resets the index entries for all <paths> to their state at <tree-ish>. (It does not affect the working tree or the current branch.)[m
[m
           This means that [1mgit[0m [1mreset[0m [1m<paths>[0m is the opposite of [1mgit[0m [1madd[0m [1m<paths>[0m.[m
[m
           After running [1mgit[0m [1mreset[0m [1m<paths>[0m to update the index entry, you can use [1mgit-checkout[0m(1) to check the contents out of the index to the working tree. Alternatively, using [1mgit-checkout[0m(1) and specifying a commit, you can copy the contents of a path out of a commit to the index and to the working tree[m
           in one go.[m
[m
       [4mgit[24m [4mreset[24m (--patch | -p) [<tree-ish>] [--] [<paths>...][m
           Interactively select hunks in the difference between the index and <tree-ish> (defaults to HEAD). The chosen hunks are applied in reverse to the index.[m
[m
           This means that [1mgit[0m [1mreset[0m [1m-p[0m is the opposite of [1mgit[0m [1madd[0m [1m-p[0m, i.e. you can use it to selectively reset hunks. See the “Interactive Mode” section of [1mgit-add[0m(1) to learn how to operate the [1m--patch[0m mode.[m
[m
       [4mgit[24m [4mreset[24m [<mode>] [<commit>][m
           This form resets the current branch head to <commit> and possibly updates the index (resetting it to the tree of <commit>) and the working tree depending on <mode>. If <mode> is omitted, defaults to "--mixed". The <mode> must be one of the following:[m
[m
           --soft[m
               Does not touch the index file or the working tree at all (but resets the head to <commit>, just like all modes do). This leaves all your changed files "Changes to be committed", as [4mgit[24m [4mstatus[24m would put it.[m
[m
           --mixed[m
               Resets the index but not the working tree (i.e., the changed files are preserved but not marked for commit) and reports what has not been updated. This is the default action.[m
[m
               If [1m-N[0m is specified, removed paths are marked as intent-to-add (see [1mgit-add[0m(1)).[m
[m
           --hard[m
               Resets the index and working tree. Any changes to tracked files in the working tree since <commit> are discarded.[m
[m
           --merge[m
               Resets the index and updates the files in the working tree that are different between <commit> and HEAD, but keeps those which are different between the index and working tree (i.e. which have changes which have not been added). If a file that is different between <commit> and the index has[m
               unstaged changes, reset is aborted.[m
[m
               In other words, --merge does something like a [4mgit[24m [4mread-tree[24m [4m-u[24m [4m-m[24m [4m<commit>[24m, but carries forward unmerged index entries.[m
[m
           --keep[m
               Resets index entries and updates files in the working tree that are different between <commit> and HEAD. If a file that is different between <commit> and HEAD has local changes, reset is aborted.[m
[m
       If you want to undo a commit other than the latest on a branch, [1mgit-revert[0m(1) is your friend.[m
[m
[1mOPTIONS[0m[m
       -q, --quiet[m
           Be quiet, only report errors.[m
[m
[1mEXAMPLES[0m[m
       Undo add[m
[m
               $ edit                                     [1m(1)[0m[m
               $ git add frotz.c filfre.c[m
               $ mailx                                    [1m(2)[0m[m
               $ git reset                                [1m(3)[0m[m
               $ git pull git://info.example.com/ nitfol  [1m(4)[0m[m
[m
           [1m1.[0m You are happily working on something, and find the changes in these files are in good order. You do not want to see them when you run "git diff", because you plan to work on other files and changes with these files are distracting.[m
           [1m2.[0m Somebody asks you to pull, and the changes sound worthy of merging.[m
           [1m3.[0m However, you already dirtied the index (i.e. your index does not match the HEAD commit). But you know the pull you are going to make does not affect frotz.c or filfre.c, so you revert the index changes for these two files. Your changes in working tree remain there.[m
           [1m4.[0m Then you can pull and merge, leaving frotz.c and filfre.c changes still in the working tree.[m
[m
       Undo a commit and redo[m
[m
               $ git commit ...[m
               $ git reset --soft HEAD^      [1m(1)[0m[m
               $ edit                        [1m(2)[0m[m
               $ git commit -a -c ORIG_HEAD  [1m(3)[0m[m
[m
           [1m1.[0m This is most often done when you remembered what you just committed is incomplete, or you misspelled your commit message, or both. Leaves working tree as it was before "reset".[m
           [1m2.[0m Make corrections to working tree files.[m
           [1m3.[0m "reset" copies the old head to .git/ORIG_HEAD; redo the commit by starting with its log message. If you do not need to edit the message further, you can give -C option instead.[m
[m
           See also the --amend option to [1mgit-commit[0m(1).[m
[m
       Undo a commit, making it a topic branch[m
[m
               $ git branch topic/wip     [1m(1)[0m[m
[7m Manual page git-reset(1) line 1 (press h for help or q to quit)[27m[K[K[?1l>[?1049l[23;0;0tblighte@cf164-19:~/csci241/lab-1-Ethan-Blight$ git reset --hard HEAD
HEAD is now at daf0dfc Added first and last name, WWU username, and GitHub username to username.txt
blighte@cf164-19:~/csci241/lab-1-Ethan-Blight$ git reset --hard HEAD
HEAD is now at daf0dfc Added first and last name, WWU username, and GitHub username to username.txt
blighte@cf164-19:~/csci241/lab-1-Ethan-Blight$ git rm testt[K.txc[Kt
fatal: pathspec 'test.txt' did not match any files
blighte@cf164-19:~/csci241/lab-1-Ethan-Blight$ nano test.txt
[?1049h[22;0;0t[1;86r(B[m[4l[?7h[39;49m[?1h=[?1h=[?1h=[?25l[39;49m(B[m[H[2J[84;151H(B[0;7m[ Reading File ](B[m[84;151H (B[0;7m[ Read 1 line ](B[m[H(B[0;7m  GNU nano 2.9.3                                                                                                                                             test.txt                                                                                                                                                        [1;316H(B[m[85d(B[0;7m^G(B[m Get Help[19G(B[0;7m^O(B[m Write Out[37G(B[0;7m^W(B[m Where Is[55G(B[0;7m^K(B[m Cut Text[73G(B[0;7m^J(B[m Justify[85;91H(B[0;7m^C(B[m Cur Pos[85;109H(B[0;7mM-U(B[m Undo[85;127H(B[0;7mM-A(B[m Mark Text     (B[0;7mM-](B[m To Bracket    (B[0;7mM-▲(B[m Previous[181G(B[0;7m^B(B[m Back[85;199H(B[0;7m^◀(B[m Prev Word[217G(B[0;7m^A(B[m Home[85;235H(B[0;7m^P(B[m Prev Line[253G(B[0;7mM--(B[m Scroll Up     (B[0;7m^▲(B[m Prev Block     (B[0;7mM-((B[m Beg of Par[86d(B[0;7m^X(B[m Exit[86;19H(B[0;7m^R(B[m Read File[37G(B[0;7m^\(B[m Replace[86;55H(B[0;7m^U(B[m Uncut Text     (B[0;7m^T(B[m To Spell[91G(B[0;7m^_(B[m Go To Line     (B[0;7mM-E(B[m Redo[86;127H(B[0;7mM-6(B[m Copy Text     (B[0;7mM-W(B[m WhereIs Next  (B[0;7mM-▼(B[m Next[86;181H(B[0;7m^F(B[m Forward[86;199H(B[0;7m^▶(B[m Next Word[217G(B[0;7m^E(B[m End[86;235H(B[0;7m^N(B[m Next Line[253G(B[0;7mM-+(B[m Scroll Down   (B[0;7m^▼(B[m Next Block     (B[0;7mM-)(B[m End of Par[84d[3d[39;49m(B[mtest text[?12l[?25h[?25l[84d[J[86;317H[?12l[?25h[86;1H[?1049l[23;0;0t[?1l>blighte@cf164-19:~/csci241/lab-1-Ethan-Blight$ git rm
usage: git rm [<options>] [--] <file>...

    -n, --dry-run         dry run
    -q, --quiet           do not list removed files
    --cached              only remove from the index
    -f, --force           override the up-to-date check
    -r                    allow recursive removal
    --ignore-unmatch      exit with a zero status even if nothing matched

blighte@cf164-19:~/csci241/lab-1-Ethan-Blight$ git add tesrt.[K[K[Kt.txt
blighte@cf164-19:~/csci241/lab-1-Ethan-Blight$ git add test.txtrm[Knano test.txt[7Pgit rmadd test.txtrm[Knano test.txt[2@git rm[C[C[C[C[C[C[C[C[C
error: the following file has changes staged in the index:
    test.txt
(use --cached to keep the file, or -f to force removal)
blighte@cf164-19:~/csci241/lab-1-Ethan-Blight$ git checkout test.txt
blighte@cf164-19:~/csci241/lab-1-Ethan-Blight$ git reset test.txt
blighte@cf164-19:~/csci241/lab-1-Ethan-Blight$ nano test.txt
[?1049h[22;0;0t[1;86r(B[m[4l[?7h[39;49m[?1h=[?1h=[?1h=[?25l[39;49m(B[m[H[2J[84;151H(B[0;7m[ Reading File ](B[m[84;151H (B[0;7m[ Read 1 line ](B[m[H(B[0;7m  GNU nano 2.9.3                                                                                                                                             test.txt                                                                                                                                                        [1;316H(B[m[85d(B[0;7m^G(B[m Get Help[19G(B[0;7m^O(B[m Write Out[37G(B[0;7m^W(B[m Where Is[55G(B[0;7m^K(B[m Cut Text[73G(B[0;7m^J(B[m Justify[85;91H(B[0;7m^C(B[m Cur Pos[85;109H(B[0;7mM-U(B[m Undo[85;127H(B[0;7mM-A(B[m Mark Text     (B[0;7mM-](B[m To Bracket    (B[0;7mM-▲(B[m Previous[181G(B[0;7m^B(B[m Back[85;199H(B[0;7m^◀(B[m Prev Word[217G(B[0;7m^A(B[m Home[85;235H(B[0;7m^P(B[m Prev Line[253G(B[0;7mM--(B[m Scroll Up     (B[0;7m^▲(B[m Prev Block     (B[0;7mM-((B[m Beg of Par[86d(B[0;7m^X(B[m Exit[86;19H(B[0;7m^R(B[m Read File[37G(B[0;7m^\(B[m Replace[86;55H(B[0;7m^U(B[m Uncut Text     (B[0;7m^T(B[m To Spell[91G(B[0;7m^_(B[m Go To Line     (B[0;7mM-E(B[m Redo[86;127H(B[0;7mM-6(B[m Copy Text     (B[0;7mM-W(B[m WhereIs Next  (B[0;7mM-▼(B[m Next[86;181H(B[0;7m^F(B[m Forward[86;199H(B[0;7m^▶(B[m Next Word[217G(B[0;7m^E(B[m End[86;235H(B[0;7m^N(B[m Next Line[253G(B[0;7mM-+(B[m Scroll Down   (B[0;7m^▼(B[m Next Block     (B[0;7mM-)(B[m End of Par[84d[3d[39;49m(B[mtest text[?12l[?25h[?25l[84d[J[86;317H[?12l[?25h[86;1H[?1049l[23;0;0t[?1l>blighte@cf164-19:~/csci241/lab-1-Ethan-Blight$ git rm test.txct[K[Kt[C test.txt- test.txtf test.txtc test.txt[1P test.txt
fatal: pathspec 'test.txt' did not match any files
blighte@cf164-19:~/csci241/lab-1-Ethan-Blight$ git add test.txt
blighte@cf164-19:~/csci241/lab-1-Ethan-Blight$ git add test.txt[2@rm -f[C[C[C[C[C[C[C[C[C[2Padd[C[C[C[C[C[C[C[C[C[2@rm -f[C[C[C[C[C[C[C[C[C
rm 'test.txt'
blighte@cf164-19:~/csci241/lab-1-Ethan-Blight$ nano test.txt
[?1049h[22;0;0t[1;86r(B[m[4l[?7h[39;49m[?1h=[?1h=[?1h=[?25l[39;49m(B[m[H[2J[84;153H(B[0;7m[ New File ](B[m[H(B[0;7m  GNU nano 2.9.3                                                                                                                                             test.txt                                                                                                                                                        [1;316H(B[m[85d(B[0;7m^G(B[m Get Help[19G(B[0;7m^O(B[m Write Out[37G(B[0;7m^W(B[m Where Is[55G(B[0;7m^K(B[m Cut Text[73G(B[0;7m^J(B[m Justify[85;91H(B[0;7m^C(B[m Cur Pos[85;109H(B[0;7mM-U(B[m Undo[85;127H(B[0;7mM-A(B[m Mark Text     (B[0;7mM-](B[m To Bracket    (B[0;7mM-▲(B[m Previous[181G(B[0;7m^B(B[m Back[85;199H(B[0;7m^◀(B[m Prev Word[217G(B[0;7m^A(B[m Home[85;235H(B[0;7m^P(B[m Prev Line[253G(B[0;7mM--(B[m Scroll Up     (B[0;7m^▲(B[m Prev Block     (B[0;7mM-((B[m Beg of Par[86d(B[0;7m^X(B[m Exit[86;19H(B[0;7m^R(B[m Read File[37G(B[0;7m^\(B[m Replace[86;55H(B[0;7m^U(B[m Uncut Text     (B[0;7m^T(B[m To Spell[91G(B[0;7m^_(B[m Go To Line     (B[0;7mM-E(B[m Redo[86;127H(B[0;7mM-6(B[m Copy Text     (B[0;7mM-W(B[m WhereIs Next  (B[0;7mM-▼(B[m Next[86;181H(B[0;7m^F(B[m Forward[86;199H(B[0;7m^▶(B[m Next Word[217G(B[0;7m^E(B[m End[86;235H(B[0;7m^N(B[m Next Line[253G(B[0;7mM-+(B[m Scroll Down   (B[0;7m^▼(B[m Next Block     (B[0;7mM-)(B[m End of Par[84d[3d[39;49m(B[m[?12l[?25h[?25l[84d[J[86;317H[?12l[?25h[86;1H[?1049l[23;0;0t[?1l>blighte@cf164-19:~/csci241/lab-1-Ethan-Blight$ git mv test.txt[K[K[K[K[K[K[K[K[K
usage: git mv [<options>] <source>... <destination>

    -v, --verbose         be verbose
    -n, --dry-run         dry run
    -f, --force           force move/rename even if target exists
    -k                    skip move/rename errors

blighte@cf164-19:~/csci241/lab-1-Ethan-Blight$ git mv test.txt test2.txt
fatal: bad source, source=test.txt, destination=test2.txt
blighte@cf164-19:~/csci241/lab-1-Ethan-Blight$ git add test.txt
fatal: pathspec 'test.txt' did not match any files
blighte@cf164-19:~/csci241/lab-1-Ethan-Blight$ touch test.txt
blighte@cf164-19:~/csci241/lab-1-Ethan-Blight$ touch test.txt[2@git add[C[C[C[C[C[C[C[C[Cmv test.txt test2.txt
fatal: not under version control, source=test.txt, destination=test2.txt
blighte@cf164-19:~/csci241/lab-1-Ethan-Blight$ git add test.txt
blighte@cf164-19:~/csci241/lab-1-Ethan-Blight$ git add test.txtmv test.txt test2.txt
blighte@cf164-19:~/csci241/lab-1-Ethan-Blight$ nano test2.txt
[?1049h[22;0;0t[1;86r(B[m[4l[?7h[39;49m[?1h=[?1h=[?1h=[?25l[39;49m(B[m[H[2J[84;151H(B[0;7m[ Reading File ](B[m[84;157H(B[0;7m 0 lines ](B[m[H(B[0;7m  GNU nano 2.9.3                                                                                                                                             test2.txt                                                                                                                                                       [1;316H(B[m[85d(B[0;7m^G(B[m Get Help[19G(B[0;7m^O(B[m Write Out[37G(B[0;7m^W(B[m Where Is[55G(B[0;7m^K(B[m Cut Text[73G(B[0;7m^J(B[m Justify[85;91H(B[0;7m^C(B[m Cur Pos[85;109H(B[0;7mM-U(B[m Undo[85;127H(B[0;7mM-A(B[m Mark Text     (B[0;7mM-](B[m To Bracket    (B[0;7mM-▲(B[m Previous[181G(B[0;7m^B(B[m Back[85;199H(B[0;7m^◀(B[m Prev Word[217G(B[0;7m^A(B[m Home[85;235H(B[0;7m^P(B[m Prev Line[253G(B[0;7mM--(B[m Scroll Up     (B[0;7m^▲(B[m Prev Block     (B[0;7mM-((B[m Beg of Par[86d(B[0;7m^X(B[m Exit[86;19H(B[0;7m^R(B[m Read File[37G(B[0;7m^\(B[m Replace[86;55H(B[0;7m^U(B[m Uncut Text     (B[0;7m^T(B[m To Spell[91G(B[0;7m^_(B[m Go To Line     (B[0;7mM-E(B[m Redo[86;127H(B[0;7mM-6(B[m Copy Text     (B[0;7mM-W(B[m WhereIs Next  (B[0;7mM-▼(B[m Next[86;181H(B[0;7m^F(B[m Forward[86;199H(B[0;7m^▶(B[m Next Word[217G(B[0;7m^E(B[m End[86;235H(B[0;7m^N(B[m Next Line[253G(B[0;7mM-+(B[m Scroll Down   (B[0;7m^▼(B[m Next Block     (B[0;7mM-)(B[m End of Par[84d[3d[39;49m(B[m[?12l[?25h[?25l[86;1H[?12l[?25h[?1049l[23;0;0t[?1l>Use "fg" to return to nano.

[1]+  Stopped                 nano test2.txt
blighte@cf164-19:~/csci241/lab-1-Ethan-Blight$ ano [K[K[K[Knano test.txt
[?1049h[22;0;0t[1;86r(B[m[4l[?7h[39;49m[?1h=[?1h=[?1h=[?25l[39;49m(B[m[H[2J[84;153H(B[0;7m[ New File ](B[m[H(B[0;7m  GNU nano 2.9.3                                                                                                                                             test.txt                                                                                                                                                        [1;316H(B[m[85d(B[0;7m^G(B[m Get Help[19G(B[0;7m^O(B[m Write Out[37G(B[0;7m^W(B[m Where Is[55G(B[0;7m^K(B[m Cut Text[73G(B[0;7m^J(B[m Justify[85;91H(B[0;7m^C(B[m Cur Pos[85;109H(B[0;7mM-U(B[m Undo[85;127H(B[0;7mM-A(B[m Mark Text     (B[0;7mM-](B[m To Bracket    (B[0;7mM-▲(B[m Previous[181G(B[0;7m^B(B[m Back[85;199H(B[0;7m^◀(B[m Prev Word[217G(B[0;7m^A(B[m Home[85;235H(B[0;7m^P(B[m Prev Line[253G(B[0;7mM--(B[m Scroll Up     (B[0;7m^▲(B[m Prev Block     (B[0;7mM-((B[m Beg of Par[86d(B[0;7m^X(B[m Exit[86;19H(B[0;7m^R(B[m Read File[37G(B[0;7m^\(B[m Replace[86;55H(B[0;7m^U(B[m Uncut Text     (B[0;7m^T(B[m To Spell[91G(B[0;7m^_(B[m Go To Line     (B[0;7mM-E(B[m Redo[86;127H(B[0;7mM-6(B[m Copy Text     (B[0;7mM-W(B[m WhereIs Next  (B[0;7mM-▼(B[m Next[86;181H(B[0;7m^F(B[m Forward[86;199H(B[0;7m^▶(B[m Next Word[217G(B[0;7m^E(B[m End[86;235H(B[0;7m^N(B[m Next Line[253G(B[0;7mM-+(B[m Scroll Down   (B[0;7m^▼(B[m Next Block     (B[0;7mM-)(B[m End of Par[84d[3d[39;49m(B[m[?12l[?25h[?25l[84d[J[86;317H[?12l[?25h[86;1H[?1049l[23;0;0t[?1l>blighte@cf164-19:~/csci241/lab-1-Ethan-Blight$ giot status[1P
On branch master
Your branch is up to date with 'origin/master'.

Changes to be committed:
  (use "git reset HEAD <file>..." to unstage)

	[32mnew file:   test2.txt[m

Untracked files:
  (use "git add <file>..." to include in what will be committed)

	[31m.test2.txt.swp[m

blighte@cf164-19:~/csci241/lab-1-Ethan-Blight$ git reset h[Khead[K[K[KHEAD[K[K[K[K[KHEAD test2.txrt[K[Kt
blighte@cf164-19:~/csci241/lab-1-Ethan-Blight$ git blamer[K
usage: git blame [<options>] [<rev-opts>] [<rev>] [--] <file>

    <rev-opts> are documented in git-rev-list(1)

    --incremental         Show blame entries as we find them, incrementally
    -b                    Show blank SHA-1 for boundary commits (Default: off)
    --root                Do not treat root commits as boundaries (Default: off)
    --show-stats          Show work cost statistics
    --progress            Force progress reporting
    --score-debug         Show output score for blame entries
    -f, --show-name       Show original filename (Default: auto)
    -n, --show-number     Show original linenumber (Default: off)
    -p, --porcelain       Show in a format designed for machine consumption
    --line-porcelain      Show porcelain format with per-line commit information
    -c                    Use the same output mode as git-annotate (Default: off)
    -t                    Show raw timestamp (Default: off)
    -l                    Show long commit SHA1 (Default: off)
    -s                    Suppress author name and timestamp (Default: off)
    -e, --show-email      Show author email instead of name (Default: off)
    -w                    Ignore whitespace differences
    --indent-heuristic    Use an experimental heuristic to improve diffs
    --minimal             Spend extra cycles to find better match
    -S <file>             Use revisions from <file> instead of calling git-rev-list
    --contents <file>     Use <file>'s contents as the final image
    -C[<score>]           Find line copies within and across files
    -M[<score>]           Find line movements within and across files
    -L <n,m>              Process only line range n,m, counting from 1
    --abbrev[=<n>]        use <n> digits to display SHA-1s

blighte@cf164-19:~/csci241/lab-1-Ethan-Blight$ git blasme[K[K[Kme[K[K[K[K[K[K[K[K[Ktouch test.txt
blighte@cf164-19:~/csci241/lab-1-Ethan-Blight$ git add test.txt
blighte@cf164-19:~/csci241/lab-1-Ethan-Blight$ git blame tesrt.t6[K[K[K[K[Kt.txt
[?1h=[K[?1l>blighte@cf164-19:~/csci241/lab-1-Ethan-Blight$ nano test.txt
[?1049h[22;0;0t[1;86r(B[m[4l[?7h[39;49m[?1h=[?1h=[?1h=[?25l[39;49m(B[m[H[2J[84;151H(B[0;7m[ Reading File ](B[m[84;157H(B[0;7m 0 lines ](B[m[H(B[0;7m  GNU nano 2.9.3                                                                                                                                             test.txt                                                                                                                                                        [1;316H(B[m[85d(B[0;7m^G(B[m Get Help[19G(B[0;7m^O(B[m Write Out[37G(B[0;7m^W(B[m Where Is[55G(B[0;7m^K(B[m Cut Text[73G(B[0;7m^J(B[m Justify[85;91H(B[0;7m^C(B[m Cur Pos[85;109H(B[0;7mM-U(B[m Undo[85;127H(B[0;7mM-A(B[m Mark Text     (B[0;7mM-](B[m To Bracket    (B[0;7mM-▲(B[m Previous[181G(B[0;7m^B(B[m Back[85;199H(B[0;7m^◀(B[m Prev Word[217G(B[0;7m^A(B[m Home[85;235H(B[0;7m^P(B[m Prev Line[253G(B[0;7mM--(B[m Scroll Up     (B[0;7m^▲(B[m Prev Block     (B[0;7mM-((B[m Beg of Par[86d(B[0;7m^X(B[m Exit[86;19H(B[0;7m^R(B[m Read File[37G(B[0;7m^\(B[m Replace[86;55H(B[0;7m^U(B[m Uncut Text     (B[0;7m^T(B[m To Spell[91G(B[0;7m^_(B[m Go To Line     (B[0;7mM-E(B[m Redo[86;127H(B[0;7mM-6(B[m Copy Text     (B[0;7mM-W(B[m WhereIs Next  (B[0;7mM-▼(B[m Next[86;181H(B[0;7m^F(B[m Forward[86;199H(B[0;7m^▶(B[m Next Word[217G(B[0;7m^E(B[m End[86;235H(B[0;7m^N(B[m Next Line[253G(B[0;7mM-+(B[m Scroll Down   (B[0;7m^▼(B[m Next Block     (B[0;7mM-)(B[m End of Par[84d[3d[39;49m(B[m[?12l[?25h[?25l[1;308H(B[0;7mModified(B[m[3dt[?12l[?25h[?25le[?12l[?25h[?25ls[?12l[?25h[?25lt[?12l[?25h[?25l [?12l[?25h[?25lt[?12l[?25h[?25lx[?12l[?25h[?25l [?12l[?25h[?25le[?12l[?25h[?25ls[?12l[?25h[?25l [?12l[?25h[?25lx[?12l[?25h[?25lt[?12l[?25h[?25l[84d(B[0;7mSave modified buffer?  (Answering "No" will DISCARD changes.)                                                                                                                                                                                                                                                                [85;1H Y(B[m Yes[K[86d(B[0;7m N(B[m No  [86;17H(B[0;7m^C(B[m Cancel[K[84;63H[?12l[?25h[?25l[85d(B[0;7m^G(B[m Get Help[85;80H(B[0;7mM-D(B[m DOS Format[85;159H(B[0;7mM-A(B[m Append[85;238H(B[0;7mM-B(B[m Backup File[86d(B[0;7m^C(B[m Cancel[17G         [86;80H(B[0;7mM-M(B[m Mac Format[86;159H(B[0;7mM-P(B[m Prepend[86;238H(B[0;7m^T(B[m To Files[84d(B[0;7mFile Name to Write: test.txt                                 (B[m[84;29H[?12l[?25h[?25l[K[1;316H[1;308H(B[0;7m        (B[m[84;151H(B[0;7m[ Wrote 1 line ](B[m[J[86;317H[?12l[?25h[86;1H[?1049l[23;0;0t[?1l>blighte@cf164-19:~/csci241/lab-1-Ethan-Blight$ nano test.txt[5@git blame[C[C[C[C[C[C[C[C[C
[?1h=00000000 (Not Committed Yet 2020-04-06 20:11:36 -0700 1) test text[m
[K[?1l>blighte@cf164-19:~/csci241/lab-1-Ethan-Blight$ git blame test.txt[5Pnano[C[C[C[C[C[C[C[C[C
[?1049h[22;0;0t[1;86r(B[m[4l[?7h[39;49m[?1h=[?1h=[?1h=[?25l[39;49m(B[m[H[2J[84;151H(B[0;7m[ Reading File ](B[m[84;151H (B[0;7m[ Read 1 line ](B[m[H(B[0;7m  GNU nano 2.9.3                                                                                                                                             test.txt                                                                                                                                                        [1;316H(B[m[85d(B[0;7m^G(B[m Get Help[19G(B[0;7m^O(B[m Write Out[37G(B[0;7m^W(B[m Where Is[55G(B[0;7m^K(B[m Cut Text[73G(B[0;7m^J(B[m Justify[85;91H(B[0;7m^C(B[m Cur Pos[85;109H(B[0;7mM-U(B[m Undo[85;127H(B[0;7mM-A(B[m Mark Text     (B[0;7mM-](B[m To Bracket    (B[0;7mM-▲(B[m Previous[181G(B[0;7m^B(B[m Back[85;199H(B[0;7m^◀(B[m Prev Word[217G(B[0;7m^A(B[m Home[85;235H(B[0;7m^P(B[m Prev Line[253G(B[0;7mM--(B[m Scroll Up     (B[0;7m^▲(B[m Prev Block     (B[0;7mM-((B[m Beg of Par[86d(B[0;7m^X(B[m Exit[86;19H(B[0;7m^R(B[m Read File[37G(B[0;7m^\(B[m Replace[86;55H(B[0;7m^U(B[m Uncut Text     (B[0;7m^T(B[m To Spell[91G(B[0;7m^_(B[m Go To Line     (B[0;7mM-E(B[m Redo[86;127H(B[0;7mM-6(B[m Copy Text     (B[0;7mM-W(B[m WhereIs Next  (B[0;7mM-▼(B[m Next[86;181H(B[0;7m^F(B[m Forward[86;199H(B[0;7m^▶(B[m Next Word[217G(B[0;7m^E(B[m End[86;235H(B[0;7m^N(B[m Next Line[253G(B[0;7mM-+(B[m Scroll Down   (B[0;7m^▼(B[m Next Block     (B[0;7mM-)(B[m End of Par[84d[3d[39;49m(B[mtest text[?12l[?25h[?25l[3;10H[?12l[?25h[?25l[1;308H(B[0;7mModified(B[m[4d[?12l[?25h[?25l[5d[?12l[?25h[?25ls[?12l[?25h[?25lw[?12l[?25h[?25le[?12l[?25h[?25lc[?12l[?25h[?25l [?12l[?25h[?25l [?12l[?25h[?25l [?12l[?25h[?25le[?12l[?25h[?25lc[?12l[?25h[?25lo[?12l[?25h[?25ln[?12l[?25h[?25ld[?12l[?25h[?25l [?12l[?25h[?25le[?12l[?25h[?25ld[?12l[?25h[?25li[?12l[?25h[?25lt[?12l[?25h[?25l [?12l[?25h[?25lw[?12l[?25h[?25li[?12l[?25h[?25lt[?12l[?25h[?25lh[?12l[?25h[?25l[84d[K[5;18H[?12l[?25h[?25lm[?12l[?25h[?25lo[?12l[?25h[?25lr[?12l[?25h[?25le[?12l[?25h[?25l [?12l[?25h[?25lt[?12l[?25h[?25le[?12l[?25h[?25lx[?12l[?25h[?25lt[?12l[?25h[?25l[84d(B[0;7mSave modified buffer?  (Answering "No" will DISCARD changes.)                                                                                                                                                                                                                                                                [85;1H Y(B[m Yes[K[86d(B[0;7m N(B[m No  [86;17H(B[0;7m^C(B[m Cancel[K[84;63H[?12l[?25h[?25l[85d(B[0;7m^G(B[m Get Help[85;80H(B[0;7mM-D(B[m DOS Format[85;159H(B[0;7mM-A(B[m Append[85;238H(B[0;7mM-B(B[m Backup File[86d(B[0;7m^C(B[m Cancel[17G         [86;80H(B[0;7mM-M(B[m Mac Format[86;159H(B[0;7mM-P(B[m Prepend[86;238H(B[0;7m^T(B[m To Files[84d(B[0;7mFile Name to Write: test.txt                                 (B[m[84;29H[?12l[?25h[?25l[K[1;316H[1;308H(B[0;7m        (B[m[84;151H(B[0;7m[ Wrote 3 lines ](B[m[J[86;317H[?12l[?25h[86;1H[?1049l[23;0;0t[?1l>blighte@cf164-19:~/csci241/lab-1-Ethan-Blight$ nano test.txt[5@git blame[C[C[C[C[C[C[C[C[C
[?1h=00000000 (Not Committed Yet 2020-04-06 20:11:56 -0700 1) test text[m
00000000 (Not Committed Yet 2020-04-06 20:11:56 -0700 2) [m
00000000 (Not Committed Yet 2020-04-06 20:11:56 -0700 3) second edit with more text[m
[K[?1l>blighte@cf164-19:~/csci241/lab-1-Ethan-Blight$ git log
[?1h=[33mcommit daf0dfc64d75742a0e89c2737485cf8ef8c4084e[m[33m ([m[1;36mHEAD -> [m[1;32mmaster[m[33m, [m[1;31morigin/master[m[33m, [m[1;31morigin/HEAD[m[33m)[m[m
Author: Ethan Blight <blighte@wwu.edu>[m
Date:   Mon Apr 6 19:21:33 2020 -0700[m
[m
    Added first and last name, WWU username, and GitHub username to username.txt[m
[m
[33mcommit 21ce8c1dacd4dfc7a29a1c46b94c671550f1ebd2[m[m
Author: Ethan Blight <blighte@wwu.edu>[m
Date:   Mon Apr 6 18:39:32 2020 -0700[m
[m
    Added part 2 (hobby) to writeup[m
[m
[33mcommit 376ee1fe9fcbc205d0e2ced772cab54d8c119aa3[m[m
Author: Ethan Blight <blighte@wwu.edu>[m
Date:   Mon Apr 6 18:33:29 2020 -0700[m
[m
    Added part 1 (names) to writeup[m
[m
[33mcommit 99ea2e0950410230ce413603f10301f7dcb4576a[m[m
Author: Ethan Blight <blighte@wwu.edu>[m
Date:   Mon Apr 6 18:28:23 2020 -0700[m
[m
    Added empty writeup[m
[m
[33mcommit 8b9e8ffd78c9aeee984ab4e1694154b25b1aa6e9[m[m
Author: swehrwein <swehrwein@gmail.com>[m
Date:   Mon Apr 6 18:18:18 2020 -0700[m
[m
    Setting up GitHub Classroom Feedback[m
[m
[33mcommit b8ebb3b16daaf174ddf180b34ca9c26be3691162[m[33m ([m[1;31morigin/feedback[m[33m)[m[m
Author: swehrwein <swehrwein@gmail.com>[m
Date:   Mon Apr 6 18:18:17 2020 -0700[m
[m
    Setting up GitHub Classroom Feedback[m
[m
[33mcommit 673d50f3e01ad1b9153439433ea34e882740075d[m[m
Author: swehrwein <swehrwein@gmail.com>[m
Date:   Mon Apr 6 18:18:16 2020 -0700[m
[m
    Initial commit[m
[K[?1l>blighte@cf164-19:~/csci241/lab-1-Ethan-Blight$ git diff
[?1h=[1mdiff --git a/test.txt b/test.txt[m[m
[1mindex e69de29..6bf789c 100644[m[m
[1m--- a/test.txt[m[m
[1m+++ b/test.txt[m[m
[36m@@ -0,0 +1,3 @@[m[m
[32m+[m[32mtest text[m[m
[32m+[m[m
[32m+[m[32msecond edit with more text[m[m
[K[?1l>blighte@cf164-19:~/csci241/lab-1-Ethan-Blight$ n an[K[K[K[Knano username.,t[K[K[K.txt
[?1049h[22;0;0t[1;86r(B[m[4l[?7h[39;49m[?1h=[?1h=[?1h=[?25l[39;49m(B[m[H[2J[84;151H(B[0;7m[ Reading File ](B[m[84;151H (B[0;7m[ Read 1 line ](B[m[H(B[0;7m  GNU nano 2.9.3                                                                                                                                           username.txt                                                                                                                                                      [1;316H(B[m[85d(B[0;7m^G(B[m Get Help[19G(B[0;7m^O(B[m Write Out[37G(B[0;7m^W(B[m Where Is[55G(B[0;7m^K(B[m Cut Text[73G(B[0;7m^J(B[m Justify[85;91H(B[0;7m^C(B[m Cur Pos[85;109H(B[0;7mM-U(B[m Undo[85;127H(B[0;7mM-A(B[m Mark Text     (B[0;7mM-](B[m To Bracket    (B[0;7mM-▲(B[m Previous[181G(B[0;7m^B(B[m Back[85;199H(B[0;7m^◀(B[m Prev Word[217G(B[0;7m^A(B[m Home[85;235H(B[0;7m^P(B[m Prev Line[253G(B[0;7mM--(B[m Scroll Up     (B[0;7m^▲(B[m Prev Block     (B[0;7mM-((B[m Beg of Par[86d(B[0;7m^X(B[m Exit[86;19H(B[0;7m^R(B[m Read File[37G(B[0;7m^\(B[m Replace[86;55H(B[0;7m^U(B[m Uncut Text     (B[0;7m^T(B[m To Spell[91G(B[0;7m^_(B[m Go To Line     (B[0;7mM-E(B[m Redo[86;127H(B[0;7mM-6(B[m Copy Text     (B[0;7mM-W(B[m WhereIs Next  (B[0;7mM-▼(B[m Next[86;181H(B[0;7m^F(B[m Forward[86;199H(B[0;7m^▶(B[m Next Word[217G(B[0;7m^E(B[m End[86;235H(B[0;7m^N(B[m Next Line[253G(B[0;7mM-+(B[m Scroll Down   (B[0;7m^▼(B[m Next Block     (B[0;7mM-)(B[m End of Par[84d[3d[39;49m(B[mEthan Blight,blighte,Ethan-Blight[?12l[?25h[?25l[84d[J[86;317H[?12l[?25h[86;1H[?1049l[23;0;0t[?1l>blighte@cf164-19:~/csci241/lab-1-Ethan-Blight$ nano usernamet[K[K[K[K[K[K[K[K[K[K[Kwriteup.txt[Cowriteup.txt writeup.txt
[?1049h[22;0;0t[1;86r(B[m[4l[?7h[39;49m[?1h=[?1h=[?1h=[?25l[39;49m(B[m[H[2J[84;151H(B[0;7m[ Reading File ](B[m[84;157H(B[0;7m 3 lines ](B[m[H(B[0;7m  GNU nano 2.9.3                                                                                                                                            writeup.txt                                                                                                                                                      [1;316H(B[m[85d(B[0;7m^G(B[m Get Help[19G(B[0;7m^O(B[m Write Out[37G(B[0;7m^W(B[m Where Is[55G(B[0;7m^K(B[m Cut Text[73G(B[0;7m^J(B[m Justify[85;91H(B[0;7m^C(B[m Cur Pos[85;109H(B[0;7mM-U(B[m Undo[85;127H(B[0;7mM-A(B[m Mark Text     (B[0;7mM-](B[m To Bracket    (B[0;7mM-▲(B[m Previous[181G(B[0;7m^B(B[m Back[85;199H(B[0;7m^◀(B[m Prev Word[217G(B[0;7m^A(B[m Home[85;235H(B[0;7m^P(B[m Prev Line[253G(B[0;7mM--(B[m Scroll Up     (B[0;7m^▲(B[m Prev Block     (B[0;7mM-((B[m Beg of Par[86d(B[0;7m^X(B[m Exit[86;19H(B[0;7m^R(B[m Read File[37G(B[0;7m^\(B[m Replace[86;55H(B[0;7m^U(B[m Uncut Text     (B[0;7m^T(B[m To Spell[91G(B[0;7m^_(B[m Go To Line     (B[0;7mM-E(B[m Redo[86;127H(B[0;7mM-6(B[m Copy Text     (B[0;7mM-W(B[m WhereIs Next  (B[0;7mM-▼(B[m Next[86;181H(B[0;7m^F(B[m Forward[86;199H(B[0;7m^▶(B[m Next Word[217G(B[0;7m^E(B[m End[86;235H(B[0;7m^N(B[m Next Line[253G(B[0;7mM-+(B[m Scroll Down   (B[0;7m^▼(B[m Next Block     (B[0;7mM-)(B[m End of Par[84d[3d[39;49m(B[m1) Ethan Blight[5d2) Hobby: Programming[3d[?12l[?25h[?25l[84d[J[86;317H[?12l[?25h[86;1H[?1049l[23;0;0t[?1l>blighte@cf164-19:~/csci241/lab-1-Ethan-Blight$ git mv wir[K[Kriteup.txt write.txt
blighte@cf164-19:~/csci241/lab-1-Ethan-Blight$ git mv writeup.txt.[K[K[K[K[K[K[K.txt writeup.txt
blighte@cf164-19:~/csci241/lab-1-Ethan-Blight$ nano writeup,.tx[K[K[K[K.txt
[?1049h[22;0;0t[1;86r(B[m[4l[?7h[39;49m[?1h=[?1h=[?1h=[?25l[39;49m(B[m[H[2J[84;151H(B[0;7m[ Reading File ](B[m[84;157H(B[0;7m 3 lines ](B[m[H(B[0;7m  GNU nano 2.9.3                                                                                                                                            writeup.txt                                                                                                                                                      [1;316H(B[m[85d(B[0;7m^G(B[m Get Help[19G(B[0;7m^O(B[m Write Out[37G(B[0;7m^W(B[m Where Is[55G(B[0;7m^K(B[m Cut Text[73G(B[0;7m^J(B[m Justify[85;91H(B[0;7m^C(B[m Cur Pos[85;109H(B[0;7mM-U(B[m Undo[85;127H(B[0;7mM-A(B[m Mark Text     (B[0;7mM-](B[m To Bracket    (B[0;7mM-▲(B[m Previous[181G(B[0;7m^B(B[m Back[85;199H(B[0;7m^◀(B[m Prev Word[217G(B[0;7m^A(B[m Home[85;235H(B[0;7m^P(B[m Prev Line[253G(B[0;7mM--(B[m Scroll Up     (B[0;7m^▲(B[m Prev Block     (B[0;7mM-((B[m Beg of Par[86d(B[0;7m^X(B[m Exit[86;19H(B[0;7m^R(B[m Read File[37G(B[0;7m^\(B[m Replace[86;55H(B[0;7m^U(B[m Uncut Text     (B[0;7m^T(B[m To Spell[91G(B[0;7m^_(B[m Go To Line     (B[0;7mM-E(B[m Redo[86;127H(B[0;7mM-6(B[m Copy Text     (B[0;7mM-W(B[m WhereIs Next  (B[0;7mM-▼(B[m Next[86;181H(B[0;7m^F(B[m Forward[86;199H(B[0;7m^▶(B[m Next Word[217G(B[0;7m^E(B[m End[86;235H(B[0;7m^N(B[m Next Line[253G(B[0;7mM-+(B[m Scroll Down   (B[0;7m^▼(B[m Next Block     (B[0;7mM-)(B[m End of Par[84d[3d[39;49m(B[m1) Ethan Blight[5d2) Hobby: Programming[3d[?12l[?25h[?25l[86;1H[?12l[?25h[?1049l[23;0;0t[?1l>Use "fg" to return to nano.

[2]+  Stopped                 nano writeup.txt
blighte@cf164-19:~/csci241/lab-1-Ethan-Blight$ aaas[K[K[K[Kfg[K[Kfg
nano writeup.txt
[?1049h[22;0;0t[1;86r[?25l[39;49m]104(B[m[4l[?7h[H[2J(B[0;7m  GNU nano 2.9.3                                                                                                                                            writeup.txt                                                                                                                                                      [3;1H(B[m1) Ethan Blight[5d2) Hobby: Programming[84;151H(B[0;7m[ Read 3 lines ][85d^G(B[m Get Help[19G(B[0;7m^O(B[m Write Out[37G(B[0;7m^W(B[m Where Is[55G(B[0;7m^K(B[m Cut Text[73G(B[0;7m^J(B[m Justify[85;91H(B[0;7m^C(B[m Cur Pos[85;109H(B[0;7mM-U(B[m Undo[85;127H(B[0;7mM-A(B[m Mark Text     (B[0;7mM-](B[m To Bracket    (B[0;7mM-▲(B[m Previous[181G(B[0;7m^B(B[m Back[85;199H(B[0;7m^◀(B[m Prev Word[217G(B[0;7m^A(B[m Home[85;235H(B[0;7m^P(B[m Prev Line[253G(B[0;7mM--(B[m Scroll Up     (B[0;7m^▲(B[m Prev Block     (B[0;7mM-((B[m Beg of Par[86d(B[0;7m^X(B[m Exit[86;19H(B[0;7m^R(B[m Read File[37G(B[0;7m^\(B[m Replace[86;55H(B[0;7m^U(B[m Uncut Text     (B[0;7m^T(B[m To Spell[91G(B[0;7m^_(B[m Go To Line     (B[0;7mM-E(B[m Redo[86;127H(B[0;7mM-6(B[m Copy Text     (B[0;7mM-W(B[m WhereIs Next  (B[0;7mM-▼(B[m Next[86;181H(B[0;7m^F(B[m Forward[86;199H(B[0;7m^▶(B[m Next Word[217G(B[0;7m^E(B[m End[86;235H(B[0;7m^N(B[m Next Line[253G(B[0;7mM-+(B[m Scroll Down   (B[0;7m^▼(B[m Next Block     (B[0;7mM-)(B[m End of Par[3d[?12l[?25h[86;1H[?1049l[23;0;0t[?1l>[?1049h[22;0;0t[1;86r[?12l[?25h[39;49m]104(B[m[4l[?7h[H[2J(B[0;7m  GNU nano 2.9.3                                                                                                                                            writeup.txt                                                                                                                                                      [3;1H(B[m1) Ethan Blight[5d2) Hobby: Programming[84;151H(B[0;7m[ Read 3 lines ][85d^G(B[m Get Help[19G(B[0;7m^O(B[m Write Out[37G(B[0;7m^W(B[m Where Is[55G(B[0;7m^K(B[m Cut Text[73G(B[0;7m^J(B[m Justify[85;91H(B[0;7m^C(B[m Cur Pos[85;109H(B[0;7mM-U(B[m Undo[85;127H(B[0;7mM-A(B[m Mark Text     (B[0;7mM-](B[m To Bracket    (B[0;7mM-▲(B[m Previous[181G(B[0;7m^B(B[m Back[85;199H(B[0;7m^◀(B[m Prev Word[217G(B[0;7m^A(B[m Home[85;235H(B[0;7m^P(B[m Prev Line[253G(B[0;7mM--(B[m Scroll Up     (B[0;7m^▲(B[m Prev Block     (B[0;7mM-((B[m Beg of Par[86d(B[0;7m^X(B[m Exit[86;19H(B[0;7m^R(B[m Read File[37G(B[0;7m^\(B[m Replace[86;55H(B[0;7m^U(B[m Uncut Text     (B[0;7m^T(B[m To Spell[91G(B[0;7m^_(B[m Go To Line     (B[0;7mM-E(B[m Redo[86;127H(B[0;7mM-6(B[m Copy Text     (B[0;7mM-W(B[m WhereIs Next  (B[0;7mM-▼(B[m Next[86;181H(B[0;7m^F(B[m Forward[86;199H(B[0;7m^▶(B[m Next Word[217G(B[0;7m^E(B[m End[86;235H(B[0;7m^N(B[m Next Line[253G(B[0;7mM-+(B[m Scroll Down   (B[0;7m^▼(B[m Next Block     (B[0;7mM-)(B[m End of Par[3d[?1h=[?1h=[?1h=[H[2J(B[0;7m  GNU nano 2.9.3                                                                                                                                            writeup.txt                                                                                                                                                      [3;1H(B[m1) Ethan Blight[5d2) Hobby: Programming[85d[1;316H[85d(B[0;7m^G(B[m Get Help[19G(B[0;7m^O(B[m Write Out[37G(B[0;7m^W(B[m Where Is[55G(B[0;7m^K(B[m Cut Text[73G(B[0;7m^J(B[m Justify[85;91H(B[0;7m^C(B[m Cur Pos[85;109H(B[0;7mM-U(B[m Undo[85;127H(B[0;7mM-A(B[m Mark Text     (B[0;7mM-](B[m To Bracket    (B[0;7mM-▲(B[m Previous[181G(B[0;7m^B(B[m Back[85;199H(B[0;7m^◀(B[m Prev Word[217G(B[0;7m^A(B[m Home[85;235H(B[0;7m^P(B[m Prev Line[253G(B[0;7mM--(B[m Scroll Up     (B[0;7m^▲(B[m Prev Block     (B[0;7mM-((B[m Beg of Par[86d(B[0;7m^X(B[m Exit[86;19H(B[0;7m^R(B[m Read File[37G(B[0;7m^\(B[m Replace[86;55H(B[0;7m^U(B[m Uncut Text     (B[0;7m^T(B[m To Spell[91G(B[0;7m^_(B[m Go To Line     (B[0;7mM-E(B[m Redo[86;127H(B[0;7mM-6(B[m Copy Text     (B[0;7mM-W(B[m WhereIs Next  (B[0;7mM-▼(B[m Next[86;181H(B[0;7m^F(B[m Forward[86;199H(B[0;7m^▶(B[m Next Word[217G(B[0;7m^E(B[m End[86;235H(B[0;7m^N(B[m Next Line[253G(B[0;7mM-+(B[m Scroll Down   (B[0;7m^▼(B[m Next Block     (B[0;7mM-)(B[m End of Par[84d[?25l[3d[?12l[?25h[?25l[85d[J[86;317H[?12l[?25h[86;1H[?1049l[23;0;0t[?1l>blighte@cf164-19:~/csci241/lab-1-Ethan-Blight$ f[Kg
g: command not found
blighte@cf164-19:~/csci241/lab-1-Ethan-Blight$ fg
nano test2.txt
[?1049h[22;0;0t[1;86r[?25l[39;49m]104(B[m[4l[?7h[H[2J(B[0;7m  GNU nano 2.9.3                                                                                                                                             test2.txt                                                                                                                                                       [84;151H[ Read 0 lines ][85d^G(B[m Get Help[19G(B[0;7m^O(B[m Write Out[37G(B[0;7m^W(B[m Where Is[55G(B[0;7m^K(B[m Cut Text[73G(B[0;7m^J(B[m Justify[85;91H(B[0;7m^C(B[m Cur Pos[85;109H(B[0;7mM-U(B[m Undo[85;127H(B[0;7mM-A(B[m Mark Text     (B[0;7mM-](B[m To Bracket    (B[0;7mM-▲(B[m Previous[181G(B[0;7m^B(B[m Back[85;199H(B[0;7m^◀(B[m Prev Word[217G(B[0;7m^A(B[m Home[85;235H(B[0;7m^P(B[m Prev Line[253G(B[0;7mM--(B[m Scroll Up     (B[0;7m^▲(B[m Prev Block     (B[0;7mM-((B[m Beg of Par[86d(B[0;7m^X(B[m Exit[86;19H(B[0;7m^R(B[m Read File[37G(B[0;7m^\(B[m Replace[86;55H(B[0;7m^U(B[m Uncut Text     (B[0;7m^T(B[m To Spell[91G(B[0;7m^_(B[m Go To Line     (B[0;7mM-E(B[m Redo[86;127H(B[0;7mM-6(B[m Copy Text     (B[0;7mM-W(B[m WhereIs Next  (B[0;7mM-▼(B[m Next[86;181H(B[0;7m^F(B[m Forward[86;199H(B[0;7m^▶(B[m Next Word[217G(B[0;7m^E(B[m End[86;235H(B[0;7m^N(B[m Next Line[253G(B[0;7mM-+(B[m Scroll Down   (B[0;7m^▼(B[m Next Block     (B[0;7mM-)(B[m End of Par[3d[?12l[?25h[86;1H[?1049l[23;0;0t[?1l>[?1049h[22;0;0t[1;86r[?12l[?25h[39;49m]104(B[m[4l[?7h[H[2J(B[0;7m  GNU nano 2.9.3                                                                                                                                             test2.txt                                                                                                                                                       [84;151H[ Read 0 lines ][85d^G(B[m Get Help[19G(B[0;7m^O(B[m Write Out[37G(B[0;7m^W(B[m Where Is[55G(B[0;7m^K(B[m Cut Text[73G(B[0;7m^J(B[m Justify[85;91H(B[0;7m^C(B[m Cur Pos[85;109H(B[0;7mM-U(B[m Undo[85;127H(B[0;7mM-A(B[m Mark Text     (B[0;7mM-](B[m To Bracket    (B[0;7mM-▲(B[m Previous[181G(B[0;7m^B(B[m Back[85;199H(B[0;7m^◀(B[m Prev Word[217G(B[0;7m^A(B[m Home[85;235H(B[0;7m^P(B[m Prev Line[253G(B[0;7mM--(B[m Scroll Up     (B[0;7m^▲(B[m Prev Block     (B[0;7mM-((B[m Beg of Par[86d(B[0;7m^X(B[m Exit[86;19H(B[0;7m^R(B[m Read File[37G(B[0;7m^\(B[m Replace[86;55H(B[0;7m^U(B[m Uncut Text     (B[0;7m^T(B[m To Spell[91G(B[0;7m^_(B[m Go To Line     (B[0;7mM-E(B[m Redo[86;127H(B[0;7mM-6(B[m Copy Text     (B[0;7mM-W(B[m WhereIs Next  (B[0;7mM-▼(B[m Next[86;181H(B[0;7m^F(B[m Forward[86;199H(B[0;7m^▶(B[m Next Word[217G(B[0;7m^E(B[m End[86;235H(B[0;7m^N(B[m Next Line[253G(B[0;7mM-+(B[m Scroll Down   (B[0;7m^▼(B[m Next Block     (B[0;7mM-)(B[m End of Par[3d[?1h=[?1h=[?1h=[H[2J(B[0;7m  GNU nano 2.9.3                                                                                                                                             test2.txt                                                                                                                                                       [85;1H(B[m[1;316H[85d(B[0;7m^G(B[m Get Help[19G(B[0;7m^O(B[m Write Out[37G(B[0;7m^W(B[m Where Is[55G(B[0;7m^K(B[m Cut Text[73G(B[0;7m^J(B[m Justify[85;91H(B[0;7m^C(B[m Cur Pos[85;109H(B[0;7mM-U(B[m Undo[85;127H(B[0;7mM-A(B[m Mark Text     (B[0;7mM-](B[m To Bracket    (B[0;7mM-▲(B[m Previous[181G(B[0;7m^B(B[m Back[85;199H(B[0;7m^◀(B[m Prev Word[217G(B[0;7m^A(B[m Home[85;235H(B[0;7m^P(B[m Prev Line[253G(B[0;7mM--(B[m Scroll Up     (B[0;7m^▲(B[m Prev Block     (B[0;7mM-((B[m Beg of Par[86d(B[0;7m^X(B[m Exit[86;19H(B[0;7m^R(B[m Read File[37G(B[0;7m^\(B[m Replace[86;55H(B[0;7m^U(B[m Uncut Text     (B[0;7m^T(B[m To Spell[91G(B[0;7m^_(B[m Go To Line     (B[0;7mM-E(B[m Redo[86;127H(B[0;7mM-6(B[m Copy Text     (B[0;7mM-W(B[m WhereIs Next  (B[0;7mM-▼(B[m Next[86;181H(B[0;7m^F(B[m Forward[86;199H(B[0;7m^▶(B[m Next Word[217G(B[0;7m^E(B[m End[86;235H(B[0;7m^N(B[m Next Line[253G(B[0;7mM-+(B[m Scroll Down   (B[0;7m^▼(B[m Next Block     (B[0;7mM-)(B[m End of Par[84d[?25l[3d[?12l[?25h[?25l[85d[J[86;317H[?12l[?25h[86;1H[?1049l[23;0;0t[?1l>blighte@cf164-19:~/csci241/lab-1-Ethan-Blight$ f[Kfg[1Pgfgnano writeup.txt[12@git mv write.txt[C[C[C[C[C[C[C[C[C[C[C[C[12Pnano[C[C[C[C[C[C[C[C[C[C[C[C
[?1049h[22;0;0t[1;86r(B[m[4l[?7h[39;49m[?1h=[?1h=[?1h=[?25l[39;49m(B[m[H[2J[84;151H(B[0;7m[ Reading File ](B[m[84;157H(B[0;7m 3 lines ](B[m[H(B[0;7m  GNU nano 2.9.3                                                                                                                                            writeup.txt                                                                                                                                                      [1;316H(B[m[85d(B[0;7m^G(B[m Get Help[19G(B[0;7m^O(B[m Write Out[37G(B[0;7m^W(B[m Where Is[55G(B[0;7m^K(B[m Cut Text[73G(B[0;7m^J(B[m Justify[85;91H(B[0;7m^C(B[m Cur Pos[85;109H(B[0;7mM-U(B[m Undo[85;127H(B[0;7mM-A(B[m Mark Text     (B[0;7mM-](B[m To Bracket    (B[0;7mM-▲(B[m Previous[181G(B[0;7m^B(B[m Back[85;199H(B[0;7m^◀(B[m Prev Word[217G(B[0;7m^A(B[m Home[85;235H(B[0;7m^P(B[m Prev Line[253G(B[0;7mM--(B[m Scroll Up     (B[0;7m^▲(B[m Prev Block     (B[0;7mM-((B[m Beg of Par[86d(B[0;7m^X(B[m Exit[86;19H(B[0;7m^R(B[m Read File[37G(B[0;7m^\(B[m Replace[86;55H(B[0;7m^U(B[m Uncut Text     (B[0;7m^T(B[m To Spell[91G(B[0;7m^_(B[m Go To Line     (B[0;7mM-E(B[m Redo[86;127H(B[0;7mM-6(B[m Copy Text     (B[0;7mM-W(B[m WhereIs Next  (B[0;7mM-▼(B[m Next[86;181H(B[0;7m^F(B[m Forward[86;199H(B[0;7m^▶(B[m Next Word[217G(B[0;7m^E(B[m End[86;235H(B[0;7m^N(B[m Next Line[253G(B[0;7mM-+(B[m Scroll Down   (B[0;7m^▼(B[m Next Block     (B[0;7mM-)(B[m End of Par[84d[3d[39;49m(B[m1) Ethan Blight[5d2) Hobby: Programming[3d[?12l[?25h[?25l[84d[J[86;317H[?12l[?25h[86;1H[?1049l[23;0;0t[?1l>blighte@cf164-19:~/csci241/lab-1-Ethan-Blight$ nano writeup.txtfg[K[1Pgfgnano writeup.txt[12@git mv write.txt[C[C[C[C[C[C[C[C[C[C[C[Cup.txt write.txt[12Pnano writeup.txtusername.txt
[?1049h[22;0;0t[1;86r(B[m[4l[?7h[39;49m[?1h=[?1h=[?1h=[?25l[39;49m(B[m[H[2J[84;151H(B[0;7m[ Reading File ](B[m[84;151H (B[0;7m[ Read 1 line ](B[m[H(B[0;7m  GNU nano 2.9.3                                                                                                                                           username.txt                                                                                                                                                      [1;316H(B[m[85d(B[0;7m^G(B[m Get Help[19G(B[0;7m^O(B[m Write Out[37G(B[0;7m^W(B[m Where Is[55G(B[0;7m^K(B[m Cut Text[73G(B[0;7m^J(B[m Justify[85;91H(B[0;7m^C(B[m Cur Pos[85;109H(B[0;7mM-U(B[m Undo[85;127H(B[0;7mM-A(B[m Mark Text     (B[0;7mM-](B[m To Bracket    (B[0;7mM-▲(B[m Previous[181G(B[0;7m^B(B[m Back[85;199H(B[0;7m^◀(B[m Prev Word[217G(B[0;7m^A(B[m Home[85;235H(B[0;7m^P(B[m Prev Line[253G(B[0;7mM--(B[m Scroll Up     (B[0;7m^▲(B[m Prev Block     (B[0;7mM-((B[m Beg of Par[86d(B[0;7m^X(B[m Exit[86;19H(B[0;7m^R(B[m Read File[37G(B[0;7m^\(B[m Replace[86;55H(B[0;7m^U(B[m Uncut Text     (B[0;7m^T(B[m To Spell[91G(B[0;7m^_(B[m Go To Line     (B[0;7mM-E(B[m Redo[86;127H(B[0;7mM-6(B[m Copy Text     (B[0;7mM-W(B[m WhereIs Next  (B[0;7mM-▼(B[m Next[86;181H(B[0;7m^F(B[m Forward[86;199H(B[0;7m^▶(B[m Next Word[217G(B[0;7m^E(B[m End[86;235H(B[0;7m^N(B[m Next Line[253G(B[0;7mM-+(B[m Scroll Down   (B[0;7m^▼(B[m Next Block     (B[0;7mM-)(B[m End of Par[84d[3d[39;49m(B[mEthan Blight,blighte,Ethan-Blight[?12l[?25h[?25l[84d[J[86;317H[?12l[?25h[86;1H[?1049l[23;0;0t[?1l>blighte@cf164-19:~/csci241/lab-1-Ethan-Blight$ git cc hr[K[K[K[K[Kcheckout question3
error: pathspec 'question3' did not match any file(s) known to git.
blighte@cf164-19:~/csci241/lab-1-Ethan-Blight$ git checkout question3-question3bquestion3 question3
A	test.txt
Switched to a new branch 'question3'
blighte@cf164-19:~/csci241/lab-1-Ethan-Blight$ [Kblighte@cf164-19:~/csci241/lab-1-Ethan-Blight$ [Kblighte@cf164-19:~/csci241/lab-1-Ethan-Blight$ [Kblighte@cf164-19:~/csci241/lab-1-Ethan-Blight$ [Kblighte@cf164-19:~/csci241/lab-1-Ethan-Blight$ nano weri[K[K[Kriteup.,t[K[K[K.txt
[?1049h[22;0;0t[1;72r(B[m[4l[?7h[39;49m[?1h=[?1h=[?1h=[?25l[39;49m(B[m[H[2J[70;134H(B[0;7m[ Reading File ](B[m[70;140H(B[0;7m 3 lines ](B[m[H(B[0;7m  GNU nano 2.9.3                                                                                                                          writeup.txt                                                                                                                                     [1;281H(B[m[71d(B[0;7m^G(B[m Get Help[18G(B[0;7m^O(B[m Write Out     (B[0;7m^W(B[m Where Is[52G(B[0;7m^K(B[m Cut Text[69G(B[0;7m^J(B[m Justify[86G(B[0;7m^C(B[m Cur Pos[103G(B[0;7mM-U(B[m Undo[71;120H(B[0;7mM-A(B[m Mark Text    (B[0;7mM-](B[m To Bracket   (B[0;7mM-▲(B[m Previous     (B[0;7m^B(B[m Back[71;188H(B[0;7m^◀(B[m Prev Word     (B[0;7m^A(B[m Home[71;222H(B[0;7m^P(B[m Prev Line     (B[0;7mM--(B[m Scroll Up    (B[0;7m^▲(B[m Prev Block[72d(B[0;7m^X(B[m Exit[72;18H(B[0;7m^R(B[m Read File     (B[0;7m^\(B[m Replace[52G(B[0;7m^U(B[m Uncut Text    (B[0;7m^T(B[m To Spell[86G(B[0;7m^_(B[m Go To Line    (B[0;7mM-E(B[m Redo[72;120H(B[0;7mM-6(B[m Copy Text    (B[0;7mM-W(B[m WhereIs Next (B[0;7mM-▼(B[m Next[72;171H(B[0;7m^F(B[m Forward[188G(B[0;7m^▶(B[m Next Word     (B[0;7m^E(B[m End[72;222H(B[0;7m^N(B[m Next Line     (B[0;7mM-+(B[m Scroll Down  (B[0;7m^▼(B[m Next Block[70d[3d[39;49m(B[m1) Ethan Blight[5d2) Hobby: Programming[3d[?12l[?25h[?25l[4d[?12l[?25h[?25l[5d[?12l[?25h[?25l[5;22H[?12l[?25h[?25l[1;273H(B[0;7mModified(B[m[6d[?12l[?25h[?25l[7d[?12l[?25h[?25l3[?12l[?25h[?25l)[?12l[?25h[?25l [?12l[?25h[?25lF[?12l[?25h[?25la[?12l[?25h[?25lv[?12l[?25h[?25lo[?12l[?25h[?25lr[?12l[?25h[?25li[?12l[?25h[?25lt[?12l[?25h[?25le[?12l[?25h[?25l [?12l[?25h[?25ls[?12l[?25h[?25lo[?12l[?25h[?25ln[?12l[?25h[?25lg[?12l[?25h[?25l:[?12l[?25h[?25l [?12l[?25h[?25lC[?12l[?25h[?25li[?12l[?25h[?25lr[70d[K[7;22H[?12l[?25h[?25lc[?12l[?25h[?25ll[?12l[?25h[?25le[?12l[?25h[?25ls[?12l[?25h[?25l [?12l[?25h[?25lb[?12l[?25h[?25ly[?12l[?25h[?25l [?12l[?25h[?25lP[?12l[?25h[?25lo[?12l[?25h[?25ls[?12l[?25h[?25lt[?12l[?25h[?25l [?12l[?25h[?25lM[?12l[?25h[?25la[?12l[?25h[?25ll[?12l[?25h[?25lo[?12l[?25h[?25ln[?12l[?25h[?25le[?12l[?25h[?25l[70d(B[0;7mSave modified buffer?  (Answering "No" will DISCARD changes.)                                                                                                                                                                                                                             [71;1H Y(B[m Yes[K[72d(B[0;7m N(B[m No  [72;17H(B[0;7m^C(B[m Cancel[K[70;63H[?12l[?25h[?25l[71d(B[0;7m^G(B[m Get Help[71;71H(B[0;7mM-D(B[m DOS Format[71;141H(B[0;7mM-A(B[m Append[71;211H(B[0;7mM-B(B[m Backup File[72d(B[0;7m^C(B[m Cancel[17G         [72;71H(B[0;7mM-M(B[m Mac Format[72;141H(B[0;7mM-P(B[m Prepend[72;211H(B[0;7m^T(B[m To Files[70d(B[0;7mFile Name to Write: writeup.txt                              (B[m[70;32H[?12l[?25h[?25l[K[1;281H[1;273H(B[0;7m        (B[m[70;133H(B[0;7m[ Wrote 5 lines ](B[m[J[72;282H[?12l[?25h[72;1H[?1049l[23;0;0t[?1l>blighte@cf164-19:~/csci241/lab-1-Ethan-Blight$ git add writeup.,tx[K[K[Ktxt
blighte@cf164-19:~/csci241/lab-1-Ethan-Blight$ git comm it[K[K[Kmit -m "Added part 3 (favorite song) to wrtie[K[K[Kiteup"
git: 'commmit' is not a git command. See 'git --help'.

The most similar command is
	commit
blighte@cf164-19:~/csci241/lab-1-Ethan-Blight$ git commmit -m "Added part 3 (favorite song) to writeup"[1P
[question3 0eca0ad] Added part 3 (favorite song) to writeup
 2 files changed, 2 insertions(+)
 create mode 100644 test.txt
blighte@cf164-19:~/csci241/lab-1-Ethan-Blight$ git checkout master
error: Your local changes to the following files would be overwritten by checkout:
	test.txt
Please commit your changes or stash them before you switch branches.
Aborting
blighte@cf164-19:~/csci241/lab-1-Ethan-Blight$ nszsn[K[K[Ka[K[Kano writeup,.t[K[K[K.txt
[?1049h[22;0;0t[1;72r(B[m[4l[?7h[39;49m[?1h=[?1h=[?1h=[?25l[39;49m(B[m[H[2J[70;134H(B[0;7m[ Reading File ](B[m[70;140H(B[0;7m 5 lines ](B[m[H(B[0;7m  GNU nano 2.9.3                                                                                                                          writeup.txt                                                                                                                                     [1;281H(B[m[71d(B[0;7m^G(B[m Get Help[18G(B[0;7m^O(B[m Write Out     (B[0;7m^W(B[m Where Is[52G(B[0;7m^K(B[m Cut Text[69G(B[0;7m^J(B[m Justify[86G(B[0;7m^C(B[m Cur Pos[103G(B[0;7mM-U(B[m Undo[71;120H(B[0;7mM-A(B[m Mark Text    (B[0;7mM-](B[m To Bracket   (B[0;7mM-▲(B[m Previous     (B[0;7m^B(B[m Back[71;188H(B[0;7m^◀(B[m Prev Word     (B[0;7m^A(B[m Home[71;222H(B[0;7m^P(B[m Prev Line     (B[0;7mM--(B[m Scroll Up    (B[0;7m^▲(B[m Prev Block[72d(B[0;7m^X(B[m Exit[72;18H(B[0;7m^R(B[m Read File     (B[0;7m^\(B[m Replace[52G(B[0;7m^U(B[m Uncut Text    (B[0;7m^T(B[m To Spell[86G(B[0;7m^_(B[m Go To Line    (B[0;7mM-E(B[m Redo[72;120H(B[0;7mM-6(B[m Copy Text    (B[0;7mM-W(B[m WhereIs Next (B[0;7mM-▼(B[m Next[72;171H(B[0;7m^F(B[m Forward[188G(B[0;7m^▶(B[m Next Word     (B[0;7m^E(B[m End[72;222H(B[0;7m^N(B[m Next Line     (B[0;7mM-+(B[m Scroll Down  (B[0;7m^▼(B[m Next Block[70d[3d[39;49m(B[m1) Ethan Blight[5d2) Hobby: Programming[7d3) Favorite song: Circles by Post Malone[3d[?12l[?25h[?25l[70d[J[72;282H[?12l[?25h[72;1H[?1049l[23;0;0t[?1l>blighte@cf164-19:~/csci241/lab-1-Ethan-Blight$ g[Knano writeup.txtgit checkout masterommit -m "Added part 3 (favorite song) to writeup"[C[1@ [1@-[1@a
[question3 1441190] Added part 3 (favorite song) to writeup
 1 file changed, 3 insertions(+)
blighte@cf164-19:~/csci241/lab-1-Ethan-Blight$ git commit -a -m "Added part 3 (favorite song) to writeup"[C[C[C[C[C[C[C[C[C[C[C[C[C[C[C[C[C[C[C[C[C[C[C[C[C[C[C[C[C[C[C[C[C[C[C[C[C[C[C[C[C[C[C[C[C[C[Cnano writeup.txt[Kgit checkout master
Switched to branch 'master'
Your branch is up to date with 'origin/master'.
blighte@cf164-19:~/csci241/lab-1-Ethan-Blight$ git merge question3
Updating daf0dfc..1441190
Fast-forward
 test.txt    | 3 [32m+++[m
 writeup.txt | 2 [32m++[m
 2 files changed, 5 insertions(+)
 create mode 100644 test.txt
blighte@cf164-19:~/csci241/lab-1-Ethan-Blight$ gitmrm[K[K[K rm test.txt
rm 'test.txt'
blighte@cf164-19:~/csci241/lab-1-Ethan-Blight$ git status
On branch master
Your branch is ahead of 'origin/master' by 2 commits.
  (use "git push" to publish your local commits)

Changes to be committed:
  (use "git reset HEAD <file>..." to unstage)

	[32mdeleted:    test.txt[m

Untracked files:
  (use "git add <file>..." to include in what will be committed)

	[31mtest2.txt[m

blighte@cf164-19:~/csci241/lab-1-Ethan-Blight$ git branch -d question34[K
Deleted branch question3 (was 1441190).
blighte@cf164-19:~/csci241/lab-1-Ethan-Blight$ nano werit[K[K[K[Kriteup.,tx[K[K[Ktxt
[?1049h[22;0;0t[1;72r(B[m[4l[?7h[39;49m[?1h=[?1h=[?1h=[?25l[39;49m(B[m[H[2J[70;134H(B[0;7m[ Reading File ](B[m[70;140H(B[0;7m 5 lines ](B[m[H(B[0;7m  GNU nano 2.9.3                                                                                                                          writeup.txt                                                                                                                                     [1;281H(B[m[71d(B[0;7m^G(B[m Get Help[18G(B[0;7m^O(B[m Write Out     (B[0;7m^W(B[m Where Is[52G(B[0;7m^K(B[m Cut Text[69G(B[0;7m^J(B[m Justify[86G(B[0;7m^C(B[m Cur Pos[103G(B[0;7mM-U(B[m Undo[71;120H(B[0;7mM-A(B[m Mark Text    (B[0;7mM-](B[m To Bracket   (B[0;7mM-▲(B[m Previous     (B[0;7m^B(B[m Back[71;188H(B[0;7m^◀(B[m Prev Word     (B[0;7m^A(B[m Home[71;222H(B[0;7m^P(B[m Prev Line     (B[0;7mM--(B[m Scroll Up    (B[0;7m^▲(B[m Prev Block[72d(B[0;7m^X(B[m Exit[72;18H(B[0;7m^R(B[m Read File     (B[0;7m^\(B[m Replace[52G(B[0;7m^U(B[m Uncut Text    (B[0;7m^T(B[m To Spell[86G(B[0;7m^_(B[m Go To Line    (B[0;7mM-E(B[m Redo[72;120H(B[0;7mM-6(B[m Copy Text    (B[0;7mM-W(B[m WhereIs Next (B[0;7mM-▼(B[m Next[72;171H(B[0;7m^F(B[m Forward[188G(B[0;7m^▶(B[m Next Word     (B[0;7m^E(B[m End[72;222H(B[0;7m^N(B[m Next Line     (B[0;7mM-+(B[m Scroll Down  (B[0;7m^▼(B[m Next Block[70d[3d[39;49m(B[m1) Ethan Blight[5d2) Hobby: Programming[7d3) Favorite song: Circles by Post Malone[3d[?12l[?25h[?25l[70d[J[72;282H[?12l[?25h[72;1H[?1049l[23;0;0t[?1l>blighte@cf164-19:~/csci241/lab-1-Ethan-Blight$ gradle build

Welcome to Gradle 6.1!

Here are the highlights of this release:
 - Dependency cache is relocatable
 - Configurable compilation order between Groovy, Java & Scala
 - New sample projects in Gradle's documentation

For more details see https://docs.gradle.org/6.1/release-notes.html

Starting a Gradle Daemon (subsequent builds will be faster)


[2A[1B[1m> Starting Daemon[m[17D[1B[1A> IDLE[0K[6D[1B[2A[1m<[0;1m-------------> 0% INITIALIZING [57ms][m[38D[1B[1m> Evaluating settings[m[21D[1B[2A[1m<[0;1m-------------> 0% INITIALIZING [157ms][m[39D[2B[2A[1m<[0;1m-------------> 0% INITIALIZING [257ms][m[39D[2B[2A[1m<[0;1m-------------> 0% INITIALIZING [357ms][m[39D[2B[2A[1m<[0;1m-------------> 0% INITIALIZING [457ms][m[39D[2B[2A[1m<[0;1m-------------> 0% INITIALIZING [557ms][m[39D[1B[1m> Evaluating settings > Compiling /home/blighte/csci241/lab-1-Ethan-Blight/settings.gradle into local compilation cache > Compiling settings file '/home/blighte/csci241/lab-1-Ethan-Blight/settings.gradle' to cross build script cache[m[232D[1B[2A[1m<[0;1m-------------> 0% INITIALIZING [657ms][m[39D[2B[2A[1m<[0;1m-------------> 0% INITIALIZING [757ms][m[39D[1B[1m> Evaluating settings > Compiling /home/blighte/csci241/lab-1-Ethan-Blight/settings.gradle into local compilation cache[m[0K[119D[1B[2A[1m<[0;1m-------------> 0% CONFIGURING [857ms][m[0K[38D[1B[1m> Loading projects[m[0K[18D[1B[2A[1m<[0;1m-------------> 0% CONFIGURING [957ms][m[38D[1B[1m> root project[m[0K[14D[1B[2A[1m<[0;1m-------------> 0% CONFIGURING [1s][m[0K[35D[2B[2A[1m<[0;32;1m=============[0;39;1m> 100% CONFIGURING [1s][m[37D[1B> IDLE[0K[6D[1B[2A[1m<[0;1m-------------> 0% EXECUTING [1s][m[0K[33D[1B[1m> :compileJava[m[14D[1B[1A[1m> :compileJava > Resolve dependencies of :compileClasspath > guava-26.0-jre.pom[m[79D[1B[2A[1m<[0;1m-------------> 0% EXECUTING [2s][m[33D[2B[1A[1m> :compileJava > Resolve dependencies of :compileClasspath > guava-parent-26.0-jre.pom[m[86D[1B[1A[1m> :compileJava > Resolve dependencies of :compileClasspath[m[0K[58D[1B



[5A[1m> :compileJava > Resolve dependencies of :compileClasspath > error_prone_annotations-2.1.3.pom[m[94D[1B[1m> :compileJava > Resolve dependencies of :compileClasspath > j2objc-annotations-1.1.pom[m[87D[1B[1m> :compileJava > Resolve dependencies of :compileClasspath > checker-qual-2.5.2.pom[m[83D[1B[1m> :compileJava > Resolve dependencies of :compileClasspath > jsr305-3.0.2.pom[m[77D[1B[1m> :compileJava > Resolve dependencies of :compileClasspath > animal-sniffer-parent-1.14.pom[m[91D[1B[5A> IDLE[0K[6D[1B[1m> :compileJava > Resolve dependencies of :compileClasspath[m[0K[58D[1B> IDLE[0K[6D[1B> IDLE[0K[6D[1B> IDLE[0K[6D[1B
[6A[1m> :compileJava > Resolve files of :compileClasspath > error_prone_annotations-2.1.3.jar[m[87D[1B[1m> :compileJava > Resolve files of :compileClasspath > guava-26.0-jre.jar[m[72D[1B[1m> :compileJava > Resolve files of :compileClasspath > j2objc-annotations-1.1.jar[m[80D[1B[1m> :compileJava > Resolve files of :compileClasspath > animal-sniffer-annotations-1.14.jar[m[89D[1B[1m> :compileJava > Resolve files of :compileClasspath > jsr305-3.0.2.jar[m[70D[1B[1m> :compileJava > Resolve files of :compileClasspath > checker-qual-2.5.2.jar[m[76D[1B[7A[1m<[0;1m-------------> 0% EXECUTING [3s][m[33D[1B> IDLE[0K[6D[1B[1m> :compileJava > Resolve files of :compileClasspath > guava-26.0-jre.jar > 1.30 MB/2.61 MB downloaded[m[101D[1B> IDLE[0K[6D[1B> IDLE[0K[6D[1B> IDLE[0K[6D[1B> IDLE[0K[6D[1B[5A[1m> :compileJava > Resolve files of :compileClasspath[m[0K[51D[5B[5A[1m> :compileJava[m[0K[14D[5B[7A[1m<[0;1m-------------> 0% EXECUTING [4s][m[33D[7B[7A[1m<[0;1m-------------> 0% EXECUTING [5s][m[33D[7B[7A[1m<[0;1m-------------> 0% EXECUTING [6s][m[33D[7B[7A[1m<[0;1m-------------> 0% EXECUTING [7s][m[33D[7B[7A[1m<[0;32;1m===[0;39;1m----------> 28% EXECUTING [7s][m[34D[2B[1m> :startScripts[m[15D[5B[7A[1m<[0;32;1m=====[0;39;1m--------> 42% EXECUTING [8s][m[34D[2B[1m> :distZip[m[0K[10D[5B[7A[1m<[0;32;1m==========[0;39;1m---> 78% EXECUTING [8s][m[34D[2B[1m> :test[m[0K[7D[5B[7A[0K
[32;1mBUILD SUCCESSFUL[0;39m in 10s
5 actionable tasks: 5 executed
[4B[0K
[0K
[0K
[7A[1m<[0;1m-------------> 0% WAITING[m[26D[1B> IDLE[6D[1B> IDLE[6D[1B> IDLE[6D[1B> IDLE[6D[1B> IDLE[6D[1B> IDLE[6D[1B[7A[2K[1B[2K[1B[2K[1B[2K[1B[2K[1B[2K[1B[2K[6A[0m[?12l[?25hblighte@cf164-19:~/csci241/lab-1-Ethan-Blight$ gtr[K[Kradle run


[2A[1m<[0;1m-------------> 0% EXECUTING [71ms][m[35D[1B[1m> :compileJava > Resolve dependencies of :compileClasspath[m[58D[1B[2A[0K
[1m> Task :run[m[0K
Hello, world!

[32;1mBUILD SUCCESSFUL[0;39m in 458ms
2 actionable tasks: 1 executed, 1 up-to-date
[0K
[0K
[2A[1m<[0;1m-------------> 0% WAITING[m[26D[1B> IDLE[6D[1B[2A[2K[1B[2K[1A[0m[?12l[?25hblighte@cf164-19:~/csci241/lab-1-Ethan-Blight$ cc [K[Kd src
blighte@cf164-19:~/csci241/lab-1-Ethan-Blight/src$ cd /main/java/lab1
bash: cd: /main/java/lab1: No such file or directory
blighte@cf164-19:~/csci241/lab-1-Ethan-Blight/src$ cd /main/java/lab1\main/java/lab1[1Pmain/java/lab1[1Pmain/java/lab1
blighte@cf164-19:~/csci241/lab-1-Ethan-Blight/src/main/java/lab1$ nano Hellol[K.java
[?1049h[22;0;0t[1;72r(B[m[4l[?7h[39;49m[?1h=[?1h=[?1h=[?25l[39;49m(B[m[H[2J[70;134H(B[0;7m[ Reading File ](B[m[70;140H(B[0;7m 7 lines ](B[m[H(B[0;7m  GNU nano 2.9.3                                                                                                                           Hello.java                                                                                                                                     [1;281H(B[m[71d(B[0;7m^G(B[m Get Help[18G(B[0;7m^O(B[m Write Out     (B[0;7m^W(B[m Where Is[52G(B[0;7m^K(B[m Cut Text[69G(B[0;7m^J(B[m Justify[86G(B[0;7m^C(B[m Cur Pos[103G(B[0;7mM-U(B[m Undo[71;120H(B[0;7mM-A(B[m Mark Text    (B[0;7mM-](B[m To Bracket   (B[0;7mM-▲(B[m Previous     (B[0;7m^B(B[m Back[71;188H(B[0;7m^◀(B[m Prev Word     (B[0;7m^A(B[m Home[71;222H(B[0;7m^P(B[m Prev Line     (B[0;7mM--(B[m Scroll Up    (B[0;7m^▲(B[m Prev Block[72d(B[0;7m^X(B[m Exit[72;18H(B[0;7m^R(B[m Read File     (B[0;7m^\(B[m Replace[52G(B[0;7m^U(B[m Uncut Text    (B[0;7m^T(B[m To Spell[86G(B[0;7m^_(B[m Go To Line    (B[0;7mM-E(B[m Redo[72;120H(B[0;7mM-6(B[m Copy Text    (B[0;7mM-W(B[m WhereIs Next (B[0;7mM-▼(B[m Next[72;171H(B[0;7m^F(B[m Forward[188G(B[0;7m^▶(B[m Next Word     (B[0;7m^E(B[m End[72;222H(B[0;7m^N(B[m Next Line     (B[0;7mM-+(B[m Scroll Down  (B[0;7m^▼(B[m Next Block[70d[3d[39;49m[36mpackage[39m(B[m lab1;[5d[36mpublic[39m(B[m [36mclass[39m(B[m Hello {[6;3H[36mpublic[39m(B[m [36mstatic[39m(B[m [32mvoid[39m(B[m main(String[] args) {[7;5HSystem.out.println([31m"Hello, world!"[39m(B[m);[8;3H}[9d}[3d[?12l[?25h[?25l[C[?12l[?25h[?25l[4d[?12l[?25h[?25l[5;2H[?12l[?25h[?25l[6d[?12l[?25h[?25l[7d[?12l[?25h[?25l[8d[?12l[?25h[?25l[9d[?12l[?25h[?25l[A[?12l[?25h[?25l[A[?12l[?25h[?25l[A[?12l[?25h[?25l [?12l[?25h[?25l[C[?12l[?25h[?25l[C[?12l[?25h[?25l[C[?12l[?25h[?25l[C[?12l[?25h[?25l[C[?12l[?25h[?25l[C[?12l[?25h[?25l [?12l[?25h[?25l[C[?12l[?25h[?25l[C[?12l[?25h[?25l[C[?12l[?25h[?25l[C[?12l[?25h[?25l[C[?12l[?25h[?25l[C[?12l[?25h[?25l [?12l[?25h[?25l[70d[K[6;18H[?12l[?25h[?25l[C[?12l[?25h[?25l[C[?12l[?25h[?25l[C[?12l[?25h[?25l [?12l[?25h[?25lm[?12l[?25h[?25la[?12l[?25h[?25li[?12l[?25h[?25l[7d[?12l[?25h[?25l[C[?12l[?25h[?25l[C[?12l[?25h[?25l[C[?12l[?25h[?25l[C[?12l[?25h[?25l[C[?12l[?25h[?25l[C[?12l[?25h[?25l[C[?12l[?25h[?25l[C[?12l[?25h[?25l[C[?12l[?25h[?25l[C[?12l[?25h[?25l[C[?12l[?25h[?25l[C[?12l[?25h[?25l[C[?12l[?25h[?25l[1;273H(B[0;7mModified(B[m[7;37H[31m"[39m(B[m);[K[?12l[?25h[?25l[31m"[39m(B[m);[K[?12l[?25h[?25l[31m"[39m(B[m);[K[?12l[?25h[?25l[31m"[39m(B[m);[K[?12l[?25h[?25l[31m"[39m(B[m);[K[?12l[?25h[?25l[31m"[39m(B[m);[K[?12l[?25h[?25l[31m"[39m(B[m);[K[?12l[?25h[?25l[31m"[39m(B[m);[K[?12l[?25h[?25l[31m "[39m(B[m);[?12l[?25h[?25l[C[?12l[?25h[?25l );[?12l[?25h[?25l+);[?12l[?25h[?25l );[?12l[?25h[?25la);[?12l[?25h[?25lr);[?12l[?25h[?25lg);[?12l[?25h[?25ls);[?12l[?25h[?25l[70d(B[0;7mSave modified buffer?  (Answering "No" will DISCARD changes.)                                                                                                                                                                                                                             [71;1H Y(B[m Yes[K[72d(B[0;7m N(B[m No  [72;17H(B[0;7m^C(B[m Cancel[K[70;63H[?12l[?25h[?25l[71d(B[0;7m^G(B[m Get Help[71;71H(B[0;7mM-D(B[m DOS Format[71;141H(B[0;7mM-A(B[m Append[71;211H(B[0;7mM-B(B[m Backup File[72d(B[0;7m^C(B[m Cancel[17G         [72;71H(B[0;7mM-M(B[m Mac Format[72;141H(B[0;7mM-P(B[m Prepend[72;211H(B[0;7m^T(B[m To Files[70d(B[0;7mFile Name to Write: Hello.java                               (B[m[70;31H[?12l[?25h[?25l[K[1;281H[1;273H(B[0;7m        (B[m[70;133H(B[0;7m[ Wrote 7 lines ](B[m[J[72;282H[?12l[?25h[72;1H[?1049l[23;0;0t[?1l>blighte@cf164-19:~/csci241/lab-1-Ethan-Blight/src/main/java/lab1$ gradle run --args="241"


[1A[1m> Connecting to Daemon[m[22D[1B[2A
[31mFAILURE: [39m[31mBuild failed with an exception.[39m

* What went wrong:
Project directory '/home/blighte/csci241/lab-1-Ethan-Blight/src/main/java/lab1' is not part of the build defined by settings file '/home/blighte/csci241/lab-1-Ethan-Blight/settings.gradle'. If this is an unrelated build, it must have its own settings file.

* Try:
Run with [1m--stacktrace[m option to get the stack trace. Run with [1m--info[m or [1m--debug[m option to get more log output. Run with [1m--scan[m to get full insights.

* Get more help at [1mhttps://help.gradle.org[m

[31;1mBUILD FAILED[0;39m in 380ms

[0K
[2A[1m<[0;1m-------------> 0% WAITING[m[26D[1B> IDLE[6D[1B[2A[2K[1B[2K[1A[0m[?12l[?25hblighte@cf164-19:~/csci241/lab-1-Ethan-Blight/src/main/java/lab1$ javac Hello.java
blighte@cf164-19:~/csci241/lab-1-Ethan-Blight/src/main/java/lab1$ javac Hello.javagradle run --args="241"


[1A[1m> Connecting to Daemon[m[22D[1B[2A
[31mFAILURE: [39m[31mBuild failed with an exception.[39m

* What went wrong:
Project directory '/home/blighte/csci241/lab-1-Ethan-Blight/src/main/java/lab1' is not part of the build defined by settings file '/home/blighte/csci241/lab-1-Ethan-Blight/settings.gradle'. If this is an unrelated build, it must have its own settings file.

* Try:
Run with [1m--stacktrace[m option to get the stack trace. Run with [1m--info[m or [1m--debug[m option to get more log output. Run with [1m--scan[m to get full insights.

* Get more help at [1mhttps://help.gradle.org[m

[31;1mBUILD FAILED[0;39m in 365ms

[0K
[2A[1m<[0;1m-------------> 0% WAITING[m[26D[1B> IDLE[6D[1B[2A[2K[1B[2K[1A[0m[?12l[?25hblighte@cf164-19:~/csci241/lab-1-Ethan-Blight/src/main/java/lab1$ java Hello.java[K[K[K[K[K
Error: Could not find or load main class Hello
Caused by: java.lang.NoClassDefFoundError: lab1/Hello (wrong name: Hello)
blighte@cf164-19:~/csci241/lab-1-Ethan-Blight/src/main/java/lab1$ java Hello.java
Hello [Ljava.lang.String;@23fe1d71
blighte@cf164-19:~/csci241/lab-1-Ethan-Blight/src/main/java/lab1$ java Hello.java[K[K[K[K[K[K[K[K[K[K[K[K[K[K[Kgradle run


[1A[1m> Connecting to Daemon[m[22D[1B[2A
[31mFAILURE: [39m[31mBuild failed with an exception.[39m

* What went wrong:
Project directory '/home/blighte/csci241/lab-1-Ethan-Blight/src/main/java/lab1' is not part of the build defined by settings file '/home/blighte/csci241/lab-1-Ethan-Blight/settings.gradle'. If this is an unrelated build, it must have its own settings file.

* Try:
Run with [1m--stacktrace[m option to get the stack trace. Run with [1m--info[m or [1m--debug[m option to get more log output. Run with [1m--scan[m to get full insights.

* Get more help at [1mhttps://help.gradle.org[m

[31;1mBUILD FAILED[0;39m in 381ms

[0K
[2A[1m<[0;1m-------------> 0% WAITING[m[26D[1B> IDLE[6D[1B[2A[2K[1B[2K[1A[0m[?12l[?25hblighte@cf164-19:~/csci241/lab-1-Ethan-Blight/src/main/java/lab1$ cd ..
blighte@cf164-19:~/csci241/lab-1-Ethan-Blight/src/main/java$ cd ..
blighte@cf164-19:~/csci241/lab-1-Ethan-Blight/src/main$ cd ..
blighte@cf164-19:~/csci241/lab-1-Ethan-Blight/src$ cd ..
blighte@cf164-19:~/csci241/lab-1-Ethan-Blight$ cd ..[K[K[K[K[Kgradle run --args [K="241"


[1A[1m> Connecting to Daemon[m[22D[1B[2A[1m<[0;1m-------------> 0% EXECUTING [70ms][m[35D[1B[1m> :compileJava[m[0K[14D[1B[2A[1m<[0;32;1m=========[0;39;1m----> 75% EXECUTING [170ms][m[37D[1B[1m> :run > Resolve dependencies of :runtimeClasspath[m[50D[1B[2A[0K
[1m> Task :run[m[0K
Hello [Ljava.lang.String;@24d46ca6

[32;1mBUILD SUCCESSFUL[0;39m in 576ms
2 actionable tasks: 2 executed
[0K
[0K
[2A[1m<[0;1m-------------> 0% WAITING[m[26D[1B> IDLE[6D[1B[2A[2K[1B[2K[1A[0m[?12l[?25hblighte@cf164-19:~/csci241/lab-1-Ethan-Blight$ cd /src/ma[K[K[K[K[K[K[Ksrc/main/java/lab1
blighte@cf164-19:~/csci241/lab-1-Ethan-Blight/src/main/java/lab1$ nano Hello.java
[?1049h[22;0;0t[1;72r(B[m[4l[?7h[39;49m[?1h=[?1h=[?1h=[?25l[39;49m(B[m[H[2J[70;134H(B[0;7m[ Reading File ](B[m[70;140H(B[0;7m 7 lines ](B[m[H(B[0;7m  GNU nano 2.9.3                                                                                                                           Hello.java                                                                                                                                     [1;281H(B[m[71d(B[0;7m^G(B[m Get Help[18G(B[0;7m^O(B[m Write Out     (B[0;7m^W(B[m Where Is[52G(B[0;7m^K(B[m Cut Text[69G(B[0;7m^J(B[m Justify[86G(B[0;7m^C(B[m Cur Pos[103G(B[0;7mM-U(B[m Undo[71;120H(B[0;7mM-A(B[m Mark Text    (B[0;7mM-](B[m To Bracket   (B[0;7mM-▲(B[m Previous     (B[0;7m^B(B[m Back[71;188H(B[0;7m^◀(B[m Prev Word     (B[0;7m^A(B[m Home[71;222H(B[0;7m^P(B[m Prev Line     (B[0;7mM--(B[m Scroll Up    (B[0;7m^▲(B[m Prev Block[72d(B[0;7m^X(B[m Exit[72;18H(B[0;7m^R(B[m Read File     (B[0;7m^\(B[m Replace[52G(B[0;7m^U(B[m Uncut Text    (B[0;7m^T(B[m To Spell[86G(B[0;7m^_(B[m Go To Line    (B[0;7mM-E(B[m Redo[72;120H(B[0;7mM-6(B[m Copy Text    (B[0;7mM-W(B[m WhereIs Next (B[0;7mM-▼(B[m Next[72;171H(B[0;7m^F(B[m Forward[188G(B[0;7m^▶(B[m Next Word     (B[0;7m^E(B[m End[72;222H(B[0;7m^N(B[m Next Line     (B[0;7mM-+(B[m Scroll Down  (B[0;7m^▼(B[m Next Block[70d[3d[39;49m[36mpackage[39m(B[m lab1;[5d[36mpublic[39m(B[m [36mclass[39m(B[m Hello {[6;3H[36mpublic[39m(B[m [36mstatic[39m(B[m [32mvoid[39m(B[m main(String[] args) {[7;5HSystem.out.println([31m"Hello "[39m(B[m + args);[8;3H}[9d}[3d[?12l[?25h[?25l[C[?12l[?25h[?25l[?12l[?25h[?25l[4d[?12l[?25h[?25l[5d[?12l[?25h[?25l[6d[?12l[?25h[?25l[7d[?12l[?25h[?25l [?12l[?25h[?25l [?12l[?25h[?25l [?12l[?25h[?25l [?12l[?25h[?25lS[?12l[?25h[?25ly[?12l[?25h[?25ls[?12l[?25h[?25lt[?12l[?25h[?25le[?12l[?25h[?25lm[?12l[?25h[?25l.[?12l[?25h[?25lo[?12l[?25h[?25lu[?12l[?25h[?25lt[?12l[?25h[?25l.[?12l[?25h[?25lp[?12l[?25h[?25lr[?12l[?25h[?25li[?12l[?25h[?25ln[?12l[?25h[?25l[70d[K[7;21H[?12l[?25h[?25ll[?12l[?25h[?25ln[?12l[?25h[?25l([?12l[?25h[?25l[C[?12l[?25h[?25l[C[?12l[?25h[?25l[C[?12l[?25h[?25l[C[?12l[?25h[?25l[C[?12l[?25h[?25l[C[?12l[?25h[?25l[C[?12l[?25h[?25l[C[?12l[?25h[?25l [?12l[?25h[?25l+[?12l[?25h[?25l [?12l[?25h[?25la[?12l[?25h[?25lr[?12l[?25h[?25lg[?12l[?25h[?25ls[?12l[?25h[?25l)[?12l[?25h[?25l[?12l[?25h[?25l[1;273H(B[0;7mModified(B[m[7;39H[);[?12l[?25h[?25l0);[?12l[?25h[?25l]);[?12l[?25h[?25l[70d(B[0;7mSave modified buffer?  (Answering "No" will DISCARD changes.)                                                                                                                                                                                                                             [71;1H Y(B[m Yes[K[72d(B[0;7m N(B[m No  [72;17H(B[0;7m^C(B[m Cancel[K[70;63H[?12l[?25h[?25l[71d(B[0;7m^G(B[m Get Help[71;71H(B[0;7mM-D(B[m DOS Format[71;141H(B[0;7mM-A(B[m Append[71;211H(B[0;7mM-B(B[m Backup File[72d(B[0;7m^C(B[m Cancel[17G         [72;71H(B[0;7mM-M(B[m Mac Format[72;141H(B[0;7mM-P(B[m Prepend[72;211H(B[0;7m^T(B[m To Files[70d(B[0;7mFile Name to Write: Hello.java                               (B[m[70;31H[?12l[?25h[?25l[K[1;281H[1;273H(B[0;7m        (B[m[70;133H(B[0;7m[ Wrote 7 lines ](B[m[J[72;282H[?12l[?25h[72;1H[?1049l[23;0;0t[?1l>blighte@cf164-19:~/csci241/lab-1-Ethan-Blight/src/main/java/lab1$ cd ..
blighte@cf164-19:~/csci241/lab-1-Ethan-Blight/src/main/java$ cd [K[K[Kcd ..
blighte@cf164-19:~/csci241/lab-1-Ethan-Blight/src/main$ cd ..
blighte@cf164-19:~/csci241/lab-1-Ethan-Blight/src$ cd ..
blighte@cf164-19:~/csci241/lab-1-Ethan-Blight$ cd ..[K[K[K[K[Kgradle run --args="241"

[1A[1m<[0;1m-------------> 0% EXECUTING [52ms][m[35D[1B
[2A[1m<[0;1m-------------> 0% EXECUTING [152ms][m[36D[1B[1m> :compileJava[m[14D[1B[2A[0K
[1m> Task :run[m[0K
Hello 241

[32;1mBUILD SUCCESSFUL[0;39m in 595ms
2 actionable tasks: 2 executed
[0K
[0K
[2A[1m<[0;1m-------------> 0% WAITING[m[26D[1B> IDLE[6D[1B[2A[2K[1B[2K[1A[0m[?12l[?25hblighte@cf164-19:~/csci241/lab-1-Ethan-Blight$ git add -s[K[K/src[K[K[K[Ksrc/main/java/lab1-[K/Hello.java
blighte@cf164-19:~/csci241/lab-1-Ethan-Blight$ git commit =[K=[K-m "Hello now prints co[K[Kcommand line as[K[Karg"
[master e50a784] Hello now prints command line arg
 2 files changed, 1 insertion(+), 4 deletions(-)
 delete mode 100644 test.txt
blighte@cf164-19:~/csci241/lab-1-Ethan-Blight$ git push
Username for 'https://github.com': blighrte   te@wwu.edu
Password for 'https://blighte@wwu.edu@github.com': 
Counting objects: 13, done.
Delta compression using up to 8 threads.
Compressing objects:  12% (1/8)   Compressing objects:  25% (2/8)   Compressing objects:  37% (3/8)   Compressing objects:  50% (4/8)   Compressing objects:  62% (5/8)   Compressing objects:  75% (6/8)   Compressing objects:  87% (7/8)   Compressing objects: 100% (8/8)   Compressing objects: 100% (8/8), done.
Writing objects:   7% (1/13)   Writing objects:  15% (2/13)   Writing objects:  23% (3/13)   Writing objects:  38% (5/13)   Writing objects:  46% (6/13)   Writing objects:  53% (7/13)   Writing objects:  61% (8/13)   Writing objects:  69% (9/13)   Writing objects:  76% (10/13)   Writing objects:  84% (11/13)   Writing objects:  92% (12/13)   Writing objects: 100% (13/13)   Writing objects: 100% (13/13), 1.06 KiB | 155.00 KiB/s, done.
Total 13 (delta 4), reused 0 (delta 0)
remote: Resolving deltas:   0% (0/4)[Kremote: Resolving deltas:  75% (3/4)[Kremote: Resolving deltas: 100% (4/4)[Kremote: Resolving deltas: 100% (4/4), completed with 2 local objects.[K
To https://github.com/csci241-20s/lab-1-Ethan-Blight
   daf0dfc..e50a784  master -> master
blighte@cf164-19:~/csci241/lab-1-Ethan-Blight$ exit
exit

Script done on 2020-04-06 20:44:28-0700
Script started on 2020-04-06 20:49:30-0700
blighte@cf164-19:~$ git d[Kfidd[K[K[K[Kfidd[K[K[K[Kdiff
Not a git repository
To compare two paths outside a working tree:
usage: git diff [--no-index] <path> <path>
blighte@cf164-19:~$ cd src/lab-1-Ethan-Blight
bash: cd: src/lab-1-Ethan-Blight: No such file or directory
blighte@cf164-19:~$ cd src/lab-1-Ethan-Blight[1P/lab-1-Ethan-Blight[1P/lab-1-Ethan-Blight[1P/lab-1-Ethan-Blights/lab-1-Ethan-Blightc/lab-1-Ethan-Blights/lab-1-Ethan-Blight[1P/lab-1-Ethan-Blight[1P/lab-1-Ethan-Blight[1P/lab-1-Ethan-Blightc/lab-1-Ethan-Blights/lab-1-Ethan-Blightc/lab-1-Ethan-Blighti/lab-1-Ethan-Blight2/lab-1-Ethan-Blight4/lab-1-Ethan-Blight1/lab-1-Ethan-Blight
blighte@cf164-19:~/csci241/lab-1-Ethan-Blight$ diff[K[K[K[Kgit diff
[?1h=[K[?1l>blighte@cf164-19:~/csci241/lab-1-Ethan-Blight$ git diff weri[K[K[K[Kwriteup.trx[K[Kxt
[?1h=[K[?1l>blighte@cf164-19:~/csci241/lab-1-Ethan-Blight$ nano writeup.txty[K
[?1049h[22;0;0t[1;72r(B[m[4l[?7h[39;49m[?1h=[?1h=[?1h=[?25l[39;49m(B[m[H[2J[70;134H(B[0;7m[ Reading File ](B[m[70;140H(B[0;7m 5 lines ](B[m[H(B[0;7m  GNU nano 2.9.3                                                                                                                          writeup.txt                                                                                                                                     [1;281H(B[m[71d(B[0;7m^G(B[m Get Help[18G(B[0;7m^O(B[m Write Out     (B[0;7m^W(B[m Where Is[52G(B[0;7m^K(B[m Cut Text[69G(B[0;7m^J(B[m Justify[86G(B[0;7m^C(B[m Cur Pos[103G(B[0;7mM-U(B[m Undo[71;120H(B[0;7mM-A(B[m Mark Text    (B[0;7mM-](B[m To Bracket   (B[0;7mM-▲(B[m Previous     (B[0;7m^B(B[m Back[71;188H(B[0;7m^◀(B[m Prev Word     (B[0;7m^A(B[m Home[71;222H(B[0;7m^P(B[m Prev Line     (B[0;7mM--(B[m Scroll Up    (B[0;7m^▲(B[m Prev Block[72d(B[0;7m^X(B[m Exit[72;18H(B[0;7m^R(B[m Read File     (B[0;7m^\(B[m Replace[52G(B[0;7m^U(B[m Uncut Text    (B[0;7m^T(B[m To Spell[86G(B[0;7m^_(B[m Go To Line    (B[0;7mM-E(B[m Redo[72;120H(B[0;7mM-6(B[m Copy Text    (B[0;7mM-W(B[m WhereIs Next (B[0;7mM-▼(B[m Next[72;171H(B[0;7m^F(B[m Forward[188G(B[0;7m^▶(B[m Next Word     (B[0;7m^E(B[m End[72;222H(B[0;7m^N(B[m Next Line     (B[0;7mM-+(B[m Scroll Down  (B[0;7m^▼(B[m Next Block[70d[3d[39;49m(B[m1) Ethan Blight[5d2) Hobby: Programming[7d3) Favorite song: Circles by Post Malone[3d[?12l[?25h[?25l[70d[J[72;282H[?12l[?25h[72;1H[?1049l[23;0;0t[?1l>blighte@cf164-19:~/csci241/lab-1-Ethan-Blight$ dfg[K[K[Kfg
bash: fg: current: no such job
blighte@cf164-19:~/csci241/lab-1-Ethan-Blight$ nano.write[K[K[K[K[K[K writeup.txt
[?1049h[22;0;0t[1;72r(B[m[4l[?7h[39;49m[?1h=[?1h=[?1h=[?25l[39;49m(B[m[H[2J[70;134H(B[0;7m[ Reading File ](B[m[70;140H(B[0;7m 5 lines ](B[m[H(B[0;7m  GNU nano 2.9.3                                                                                                                          writeup.txt                                                                                                                                     [1;281H(B[m[71d(B[0;7m^G(B[m Get Help[18G(B[0;7m^O(B[m Write Out     (B[0;7m^W(B[m Where Is[52G(B[0;7m^K(B[m Cut Text[69G(B[0;7m^J(B[m Justify[86G(B[0;7m^C(B[m Cur Pos[103G(B[0;7mM-U(B[m Undo[71;120H(B[0;7mM-A(B[m Mark Text    (B[0;7mM-](B[m To Bracket   (B[0;7mM-▲(B[m Previous     (B[0;7m^B(B[m Back[71;188H(B[0;7m^◀(B[m Prev Word     (B[0;7m^A(B[m Home[71;222H(B[0;7m^P(B[m Prev Line     (B[0;7mM--(B[m Scroll Up    (B[0;7m^▲(B[m Prev Block[72d(B[0;7m^X(B[m Exit[72;18H(B[0;7m^R(B[m Read File     (B[0;7m^\(B[m Replace[52G(B[0;7m^U(B[m Uncut Text    (B[0;7m^T(B[m To Spell[86G(B[0;7m^_(B[m Go To Line    (B[0;7mM-E(B[m Redo[72;120H(B[0;7mM-6(B[m Copy Text    (B[0;7mM-W(B[m WhereIs Next (B[0;7mM-▼(B[m Next[72;171H(B[0;7m^F(B[m Forward[188G(B[0;7m^▶(B[m Next Word     (B[0;7m^E(B[m End[72;222H(B[0;7m^N(B[m Next Line     (B[0;7mM-+(B[m Scroll Down  (B[0;7m^▼(B[m Next Block[70d[3d[39;49m(B[m1) Ethan Blight[5d2) Hobby: Programming[7d3) Favorite song: Circles by Post Malone[3d[?12l[?25h[?25l[4d[?12l[?25h[?25l[5d[?12l[?25h[?25l[6d[?12l[?25h[?25l[7d[?12l[?25h[?25l[8d[?12l[?25h[?25l[?12l[?25h[?25l[A[?12l[?25h[?25l3[?12l[?25h[?25l)[?12l[?25h[?25l [?12l[?25h[?25lF[?12l[?25h[?25la[?12l[?25h[?25lv[?12l[?25h[?25lo[?12l[?25h[?25lr[?12l[?25h[?25li[?12l[?25h[?25lt[?12l[?25h[?25le[?12l[?25h[?25l [?12l[?25h[?25ls[?12l[?25h[?25lo[?12l[?25h[?25ln[?12l[?25h[?25lg[?12l[?25h[?25l:[?12l[?25h[?25l [?12l[?25h[?25l[70d[K[7;20H[?12l[?25h[?25li[?12l[?25h[?25lr[?12l[?25h[?25lc[?12l[?25h[?25ll[?12l[?25h[?25le[?12l[?25h[?25ls[?12l[?25h[?25l [?12l[?25h[?25lb[?12l[?25h[?25ly[?12l[?25h[?25l [?12l[?25h[?25lP[?12l[?25h[?25lo[?12l[?25h[?25ls[?12l[?25h[?25lt[?12l[?25h[?25l [?12l[?25h[?25lM[?12l[?25h[?25la[?12l[?25h[?25ll[?12l[?25h[?25lo[?12l[?25h[?25ln[?12l[?25h[?25le[?12l[?25h[?25l[1;273H(B[0;7mModified(B[m[7;40H [?12l[?25h[?25l [?12l[?25h[?25ln[?12l[?25h[?25le[?12l[?25h[?25l[70d(B[0;7mSave modified buffer?  (Answering "No" will DISCARD changes.)                                                                                                                                                                                                                             [71;1H Y(B[m Yes[K[72d(B[0;7m N(B[m No  [72;17H(B[0;7m^C(B[m Cancel[K[70;63H[?12l[?25h[?25l[71d(B[0;7m^G(B[m Get Help[71;71H(B[0;7mM-D(B[m DOS Format[71;141H(B[0;7mM-A(B[m Append[71;211H(B[0;7mM-B(B[m Backup File[72d(B[0;7m^C(B[m Cancel[17G         [72;71H(B[0;7mM-M(B[m Mac Format[72;141H(B[0;7mM-P(B[m Prepend[72;211H(B[0;7m^T(B[m To Files[70d(B[0;7mFile Name to Write: writeup.txt                              (B[m[70;32H[?12l[?25h[?25l[K[1;281H[1;273H(B[0;7m        (B[m[70;133H(B[0;7m[ Wrote 5 lines ](B[m[J[72;282H[?12l[?25h[72;1H[?1049l[23;0;0t[?1l>blighte@cf164-19:~/csci241/lab-1-Ethan-Blight$ nano writeup.txtfg[Knano writeup.txt[K[K[K[K[K[K[K[K[K[K[K[K[K[K[K[Kgit diff writeup.rtx[K[K[Ktxt
[?1h=[K[?1l>blighte@cf164-19:~/csci241/lab-1-Ethan-Blight$ git diff
[?1h=[K[?1l>blighte@cf164-19:~/csci241/lab-1-Ethan-Blight$ git add writeup.rxt[K[K[Ktxt
blighte@cf164-19:~/csci241/lab-1-Ethan-Blight$ git add writeup.txtdiff[Kadd writeup.txtdiff[K writeup.txt[4Pnano[C[C[C[C[C[C[C[C[C[C[C[C[4@git diff[C[C[C[C[C[C[C[C[C[C[C[C
[?1h=[K[?1l>blighte@cf164-19:~/csci241/lab-1-Ethan-Blight$ git diff writeup.txt[1Padd[C[C[C[C[C[C[C[C[C[C[C[Cdiff[K writeup.txt[K
[?1h=[K[?1l>blighte@cf164-19:~/csci241/lab-1-Ethan-Blight$ nano[K[K[K[Kcd src/main/java
blighte@cf164-19:~/csci241/lab-1-Ethan-Blight/src/main/java$ /[Kcd lab1
blighte@cf164-19:~/csci241/lab-1-Ethan-Blight/src/main/java/lab1$ nano Hello.java
[?1049h[22;0;0t[1;72r(B[m[4l[?7h[39;49m[?1h=[?1h=[?1h=[?25l[39;49m(B[m[H[2J[70;134H(B[0;7m[ Reading File ](B[m[70;140H(B[0;7m 7 lines ](B[m[H(B[0;7m  GNU nano 2.9.3                                                                                                                           Hello.java                                                                                                                                     [1;281H(B[m[71d(B[0;7m^G(B[m Get Help[18G(B[0;7m^O(B[m Write Out     (B[0;7m^W(B[m Where Is[52G(B[0;7m^K(B[m Cut Text[69G(B[0;7m^J(B[m Justify[86G(B[0;7m^C(B[m Cur Pos[103G(B[0;7mM-U(B[m Undo[71;120H(B[0;7mM-A(B[m Mark Text    (B[0;7mM-](B[m To Bracket   (B[0;7mM-▲(B[m Previous     (B[0;7m^B(B[m Back[71;188H(B[0;7m^◀(B[m Prev Word     (B[0;7m^A(B[m Home[71;222H(B[0;7m^P(B[m Prev Line     (B[0;7mM--(B[m Scroll Up    (B[0;7m^▲(B[m Prev Block[72d(B[0;7m^X(B[m Exit[72;18H(B[0;7m^R(B[m Read File     (B[0;7m^\(B[m Replace[52G(B[0;7m^U(B[m Uncut Text    (B[0;7m^T(B[m To Spell[86G(B[0;7m^_(B[m Go To Line    (B[0;7mM-E(B[m Redo[72;120H(B[0;7mM-6(B[m Copy Text    (B[0;7mM-W(B[m WhereIs Next (B[0;7mM-▼(B[m Next[72;171H(B[0;7m^F(B[m Forward[188G(B[0;7m^▶(B[m Next Word     (B[0;7m^E(B[m End[72;222H(B[0;7m^N(B[m Next Line     (B[0;7mM-+(B[m Scroll Down  (B[0;7m^▼(B[m Next Block[70d[3d[39;49m[36mpackage[39m(B[m lab1;[5d[36mpublic[39m(B[m [36mclass[39m(B[m Hello {[6;3H[36mpublic[39m(B[m [36mstatic[39m(B[m [32mvoid[39m(B[m main(String[] args) {[7;5HSystem.out.println([31m"Hello "[39m(B[m + args[0]);[8;3H}[9d}[3d[?12l[?25h[?25l[?12l[?25h[?25l[4d[?12l[?25h[?25l[5d[?12l[?25h[?25l[6d[?12l[?25h[?25l[7d[?12l[?25h[?25l [?12l[?25h[?25l [?12l[?25h[?25l [?12l[?25h[?25l [?12l[?25h[?25lS[?12l[?25h[?25ly[?12l[?25h[?25ls[?12l[?25h[?25lt[?12l[?25h[?25le[?12l[?25h[?25lm[?12l[?25h[?25l.[?12l[?25h[?25lo[?12l[?25h[?25lu[?12l[?25h[?25lt[?12l[?25h[?25l.[?12l[?25h[?25lp[?12l[?25h[?25lr[?12l[?25h[?25li[?12l[?25h[?25ln[?12l[?25h[?25lt[?12l[?25h[?25l[70d[K[7;22H[?12l[?25h[?25ln[?12l[?25h[?25l([?12l[?25h[?25l[C[?12l[?25h[?25l[C[?12l[?25h[?25l[C[?12l[?25h[?25l[C[?12l[?25h[?25l[C[?12l[?25h[?25l[C[?12l[?25h[?25l[C[?12l[?25h[?25l[C[?12l[?25h[?25l [?12l[?25h[?25l+[?12l[?25h[?25l [?12l[?25h[?25la[?12l[?25h[?25lr[?12l[?25h[?25lg[?12l[?25h[?25ls[?12l[?25h[?25l[[?12l[?25h[?25l0[?12l[?25h[?25l][?12l[?25h[?25l[1;273H(B[0;7mModified(B[m[7;42H );[?12l[?25h[?25l+);[?12l[?25h[?25l );[?12l[?25h[?25l");[?12l[?25h[?25l!);[?12l[?25h[?25l[31m"!"[39m(B[m);[?12l[?25h[?25l)[?12l[?25h[?25l;[?12l[?25h[?25l[70d(B[0;7mSave modified buffer?  (Answering "No" will DISCARD changes.)                                                                                                                                                                                                                             [71;1H Y(B[m Yes[K[72d(B[0;7m N(B[m No  [72;17H(B[0;7m^C(B[m Cancel[K[70;63H[?12l[?25h[?25l[71d(B[0;7m^G(B[m Get Help[71;71H(B[0;7mM-D(B[m DOS Format[71;141H(B[0;7mM-A(B[m Append[71;211H(B[0;7mM-B(B[m Backup File[72d(B[0;7m^C(B[m Cancel[17G         [72;71H(B[0;7mM-M(B[m Mac Format[72;141H(B[0;7mM-P(B[m Prepend[72;211H(B[0;7m^T(B[m To Files[70d(B[0;7mFile Name to Write: Hello.java                               (B[m[70;31H[?12l[?25h[?25l[K[1;281H[1;273H(B[0;7m        (B[m[70;133H(B[0;7m[ Wrote 7 lines ](B[m[J[72;282H[?12l[?25h[72;1H[?1049l[23;0;0t[?1l>blighte@cf164-19:~/csci241/lab-1-Ethan-Blight/src/main/java/lab1$ git add Hello.java
blighte@cf164-19:~/csci241/lab-1-Ethan-Blight/src/main/java/lab1$ cd ..
blighte@cf164-19:~/csci241/lab-1-Ethan-Blight/src/main/java$ cd ..
blighte@cf164-19:~/csci241/lab-1-Ethan-Blight/src/main$ cd ..
blighte@cf164-19:~/csci241/lab-1-Ethan-Blight/src$ cd ..
blighte@cf164-19:~/csci241/lab-1-Ethan-Blight$ git add[K[Kd[K[K[K[K[K[Kgradle run --args="241"


[1A[1m> Connecting to Daemon[m[22D[1B[2A[1m<[0;1m-------------> 0% EXECUTING [58ms][m[35D[1B> IDLE[0K[6D[1B[2A[1m<[0;1m-------------> 0% EXECUTING [158ms][m[36D[1B[1m> :compileJava[m[14D[1B[2A[0K
[1m> Task :run[m[0K
Hello 241!

[32;1mBUILD SUCCESSFUL[0;39m in 602ms
2 actionable tasks: 2 executed
[0K
[0K
[2A[1m<[0;1m-------------> 0% WAITING[m[26D[1B> IDLE[6D[1B[2A[2K[1B[2K[1A[0m[?12l[?25hblighte@cf164-19:~/csci241/lab-1-Ethan-Blight$ git add src/main/java/lab1/he[K[KHello.java
blighte@cf164-19:~/csci241/lab-1-Ethan-Blight$ git commiut [K[K[Kt +[K-m "Hello now prints command line arg (added[K[K[K[K[K[K[K[Kg"
[master 8128540] Hello now prints command line arg
 1 file changed, 1 insertion(+), 1 deletion(-)
blighte@cf164-19:~/csci241/lab-1-Ethan-Blight$ git push
Username for 'https://github.com': blighte@wwu.edu
Password for 'https://blighte@wwu.edu@github.com': 
Counting objects: 7, done.
Delta compression using up to 8 threads.
Compressing objects:  33% (1/3)   Compressing objects:  66% (2/3)   Compressing objects: 100% (3/3)   Compressing objects: 100% (3/3), done.
Writing objects:  14% (1/7)   Writing objects:  28% (2/7)   Writing objects:  42% (3/7)   Writing objects:  57% (4/7)   Writing objects:  71% (5/7)   Writing objects:  85% (6/7)   Writing objects: 100% (7/7)   Writing objects: 100% (7/7), 484 bytes | 121.00 KiB/s, done.
Total 7 (delta 2), reused 0 (delta 0)
remote: Resolving deltas:   0% (0/2)[Kremote: Resolving deltas:  50% (1/2)[Kremote: Resolving deltas: 100% (2/2)[Kremote: Resolving deltas: 100% (2/2), completed with 2 local objects.[K
To https://github.com/csci241-20s/lab-1-Ethan-Blight
   e50a784..8128540  master -> master
blighte@cf164-19:~/csci241/lab-1-Ethan-Blight$ exit
exit

Script done on 2020-04-06 20:56:27-0700
